0 0 0 0 0 0 0 0 0 0 0 0 0 0 0 0 0 0 0 0 0 0 0 0 0 0 0 0 0 0 0 0 0 0 0 0 0 0 0 0 0 0 0 0 0 0 0 0 0 0 
0 0 0 0 0 0 0 0 0 0 0 0 0 0 0 0 0 0 0 0 0 0 0 0 0 0 0 0 0 0 0 0 0 0 0 0 0 0 0 0 0 0 0 0 0 0 0 0 0 0 
0 0 0 0 0 0 0 0 0 0 0 0 0 0 0 0 0 0 0 0 0 0 0 0 0 0 0 0 0 0 0 0 0 0 0 0 0 0 0 0 0 0 0 0 0 0 0 0 0 0 
0 0 0 0 0 0 0 0 0 0 0 0 0 0 0 0 0 0 0 0 0 112 112 112 112 112 112 112 112 112 112 112 112 112 112 112 112 112 112 112 112 112 112 0 0 0 0 0 0 0 
0 0 0 0 0 0 0 112 112 112 112 112 112 112 112 112 112 112 112 0 110 32 32 32 32 32 32 32 32 32 32 32 32 32 32 32 32 32 32 32 32 32 32 111 0 0 0 0 0 0 
0 0 0 0 0 0 110 32 32 32 32 109 48 108 32 32 32 32 32 111 110 32 32 32 32 32 32 32 32 32 32 32 32 32 32 32 32 32 32 32 32 32 32 111 0 0 0 0 0 0 
0 0 0 0 0 0 110 32 32 32 32 50 121 49 32 32 32 32 32 111 110 17 17 17 17 17 17 17 17 17 17 17 17 17 17 17 17 17 17 17 17 17 17 111 0 0 0 0 0 0 
0 0 0 0 0 0 110 32 32 32 32 50 0 49 32 32 32 32 32 111 110 17 17 32 32 17 17 17 17 17 17 17 17 17 17 17 17 17 17 17 17 17 17 111 0 0 0 0 0 0 
0 0 0 0 0 0 110 17 17 17 17 17 17 17 17 17 17 17 17 111 110 17 17 32 17 17 17 17 17 17 17 17 17 17 17 17 17 17 17 17 17 17 17 111 0 0 0 0 0 0 
0 0 0 0 0 0 110 17 17 17 17 17 17 17 17 17 17 17 17 111 110 17 17 17 17 17 17 17 17 17 17 17 115 113 113 117 17 17 115 113 113 113 113 0 0 0 0 0 0 0 
0 0 0 0 0 0 110 17 17 17 17 17 17 17 17 17 17 17 17 111 110 17 17 17 17 17 17 17 17 32 17 17 111 0 0 110 17 17 111 0 0 0 0 0 0 0 0 0 0 0 
0 0 0 0 0 0 110 17 17 17 17 17 17 17 17 17 17 17 17 111 110 17 17 17 17 17 17 17 32 32 17 17 111 0 112 116 17 17 114 112 112 112 112 0 0 0 0 0 0 0 
0 0 0 0 0 0 110 17 17 17 17 17 17 17 17 17 17 17 17 111 110 17 17 17 17 17 17 17 17 17 17 17 111 110 17 17 17 17 17 17 17 17 17 111 0 0 0 0 0 0 
0 0 0 0 0 0 0 113 113 113 113 113 113 113 113 113 117 17 17 111 110 17 17 17 17 115 113 113 113 113 113 113 0 110 17 17 17 17 17 17 17 17 17 111 0 0 0 0 0 0 
0 0 0 0 0 0 0 112 112 112 112 112 112 0 0 0 110 17 17 111 110 17 17 17 17 111 0 0 0 112 112 112 112 116 17 17 17 17 17 17 17 17 17 111 0 0 0 0 0 0 
0 0 0 0 0 0 110 32 32 32 32 32 32 111 0 0 110 17 17 111 110 17 17 17 17 111 0 112 116 32 32 32 32 32 17 17 17 17 17 17 17 17 17 111 0 0 0 0 0 0 
0 0 0 0 0 0 110 32 32 32 32 32 32 111 0 0 110 17 17 111 110 17 17 17 17 111 110 32 32 32 32 32 32 32 17 17 17 17 17 17 17 17 17 111 0 0 0 0 0 0 
0 0 0 0 0 0 110 17 17 17 17 17 17 111 0 0 110 17 17 111 110 17 17 17 17 111 110 32 32 17 17 17 17 17 17 17 17 17 17 17 17 17 17 111 0 0 0 0 0 0 
0 0 0 0 0 0 110 17 17 17 17 17 17 111 0 0 110 17 17 111 110 17 17 17 17 111 110 17 17 17 17 17 17 17 17 115 113 117 17 17 115 113 113 0 0 0 0 0 0 0 
0 0 0 0 0 0 110 17 17 17 17 17 17 111 0 0 110 17 17 111 110 17 17 17 17 111 110 17 17 17 17 115 113 113 113 0 0 110 17 17 111 0 0 0 0 0 0 0 0 0 
0 0 0 0 0 0 110 17 17 17 17 17 17 111 0 0 110 17 17 111 0 113 113 113 113 0 110 17 17 17 17 111 112 112 112 112 112 116 17 17 114 112 112 0 0 0 0 0 0 0 
0 0 0 0 0 0 110 17 17 17 17 17 17 114 112 112 116 17 17 114 112 112 112 0 0 0 0 113 113 113 113 110 32 32 32 32 32 32 17 17 32 32 32 111 0 0 0 0 0 0 
0 0 0 0 0 0 110 17 17 115 113 113 117 32 32 32 32 17 17 32 32 32 32 111 0 0 0 0 0 0 0 110 32 32 32 32 32 32 17 17 32 32 32 111 0 0 0 0 0 0 
0 0 0 0 0 0 110 17 17 111 0 0 110 32 32 32 32 17 17 32 32 32 32 111 0 0 0 0 0 0 0 110 17 17 17 17 17 17 17 17 17 17 17 111 0 0 0 0 0 0 
0 0 0 0 0 0 110 17 17 111 0 0 110 17 17 17 17 17 17 17 17 17 17 114 112 112 112 112 112 112 112 116 17 17 32 32 17 17 17 17 32 32 17 111 0 0 0 0 0 0 
0 0 0 0 0 0 110 17 17 111 0 0 110 17 17 17 17 17 17 17 17 17 17 32 32 32 32 32 32 32 32 32 17 17 32 17 17 17 17 17 17 32 17 111 0 0 0 0 0 0 
0 0 0 0 0 0 110 17 17 114 112 112 116 17 17 17 17 17 17 17 17 17 17 32 32 32 32 32 32 32 32 32 17 17 17 17 17 17 17 17 17 17 17 111 0 0 0 0 0 0 
0 0 0 0 0 0 110 17 17 17 17 17 17 17 17 17 17 17 17 17 17 17 17 17 17 17 17 17 17 17 17 17 17 17 17 17 17 17 17 17 17 17 17 111 0 0 0 0 0 0 
0 0 0 0 0 0 110 17 17 17 17 17 17 17 17 17 17 17 17 17 17 17 17 17 17 17 17 17 17 17 17 17 17 17 17 17 17 17 17 17 17 17 17 111 0 0 0 0 0 0 
0 0 0 0 0 0 110 17 17 17 17 17 17 17 115 113 117 17 17 115 113 113 113 113 113 117 17 115 113 113 113 117 17 17 17 17 17 17 17 17 17 17 17 111 0 0 0 0 0 0 
0 0 0 0 0 0 110 17 17 17 17 17 17 17 111 0 110 17 17 111 0 0 0 0 112 116 17 114 112 0 0 110 17 17 32 17 17 17 17 17 17 32 17 111 0 0 0 0 0 0 
0 0 0 0 0 0 110 17 17 17 17 17 17 17 111 0 110 17 17 111 0 0 0 110 32 32 17 32 32 111 0 110 17 17 32 32 17 17 17 17 32 32 17 111 0 0 0 0 0 0 
0 0 0 0 0 0 110 17 17 17 17 17 17 17 111 0 110 17 17 111 0 0 0 110 32 32 17 32 32 111 0 110 17 17 17 17 17 17 17 17 17 17 17 111 0 0 0 0 0 0 
0 0 0 0 0 0 0 113 113 113 113 113 113 113 0 0 110 17 17 111 0 0 0 110 17 17 17 17 17 111 0 0 113 113 113 113 113 113 113 113 113 113 113 0 0 0 0 0 0 0 
0 0 0 0 0 0 0 112 112 112 112 112 112 112 112 112 116 17 17 114 112 0 0 110 17 17 17 17 17 111 0 112 112 112 112 112 112 112 112 112 112 112 112 0 0 0 0 0 0 0 
0 0 0 0 0 0 110 32 32 32 32 32 32 32 32 32 32 17 17 32 32 111 0 110 17 17 17 17 17 111 110 32 32 32 32 32 32 32 32 32 32 32 32 111 0 0 0 0 0 0 
0 0 0 0 0 0 110 32 32 32 32 32 32 32 32 32 32 17 17 32 32 111 0 0 113 113 113 113 113 0 110 32 32 32 32 32 32 32 32 32 32 32 32 111 0 0 0 0 0 0 
0 0 0 0 0 0 110 17 17 17 17 17 17 17 17 17 17 17 17 17 17 114 112 112 112 112 112 112 112 112 116 17 17 17 17 17 17 17 17 17 17 17 17 111 0 0 0 0 0 0 
0 0 0 0 0 0 110 17 17 17 17 17 17 17 17 17 17 17 17 17 17 32 32 32 32 32 32 32 32 32 32 17 17 17 17 17 17 17 17 17 17 17 17 111 0 0 0 0 0 0 
0 0 0 0 0 0 110 17 17 17 17 17 115 117 17 17 17 17 17 17 17 32 32 32 32 32 32 32 32 32 32 17 17 17 32 32 17 17 17 17 17 17 17 111 0 0 0 0 0 0 
0 0 0 0 0 0 110 17 17 17 17 17 111 110 17 17 17 17 17 17 17 17 17 17 17 17 17 17 17 17 17 17 17 17 32 17 17 17 17 32 17 17 17 111 0 0 0 0 0 0 
0 0 0 0 0 0 110 17 17 17 17 17 111 110 17 17 17 17 17 17 17 17 17 17 17 17 17 17 17 17 17 17 17 17 17 17 17 17 32 32 17 17 17 111 0 0 0 0 0 0 
0 0 0 0 0 0 110 17 17 17 17 17 111 110 17 17 17 17 17 17 17 115 113 113 113 113 113 113 113 113 117 17 17 17 17 17 17 17 17 17 17 17 17 111 0 0 0 0 0 0 
0 0 0 0 0 0 0 113 117 0 115 113 0 0 113 113 113 113 113 113 113 0 0 0 0 0 0 0 0 0 110 17 17 17 17 17 17 17 17 17 17 17 17 111 0 0 0 0 0 0 
0 0 0 0 0 0 0 0 0 121 0 0 0 0 0 0 0 0 0 0 0 0 0 0 0 0 0 0 0 0 0 113 113 113 113 113 113 113 113 113 113 113 113 0 0 0 0 0 0 0 
0 0 0 0 0 0 0 0 0 0 0 0 0 0 0 0 0 0 0 0 0 0 0 0 0 0 0 0 0 0 0 0 0 0 0 0 0 0 0 0 0 0 0 0 0 0 0 0 0 0 
0 0 0 0 0 0 0 0 0 0 0 0 0 0 0 0 0 0 0 0 0 0 0 0 0 0 0 0 0 0 0 0 0 0 0 0 0 0 0 0 0 0 0 0 0 0 0 0 0 0 
0 0 0 0 0 0 0 0 0 0 0 0 0 0 0 0 0 0 0 0 0 0 0 0 0 0 0 0 0 0 0 0 0 0 0 0 0 0 0 0 0 0 0 0 0 0 0 0 0 0 
0 0 0 0 0 0 0 0 0 0 0 0 0 0 0 0 0 0 0 0 0 0 0 0 0 0 0 0 0 0 0 0 0 0 0 0 0 0 0 0 0 0 0 0 0 0 0 0 0 0 
0 0 0 0 0 0 0 0 0 0 0 0 0 0 0 0 0 0 0 0 0 0 0 0 0 0 0 0 0 0 0 0 0 0 0 0 0 0 0 0 0 0 0 0 0 0 0 0 0 0 
