0 0 0 0 0 0 0 0 0 0 0 0 0 0 0 0 0 0 0 0 0 0 0 0 0 0 0 0 0 0 0 0 0 0 0 0 0 0 0 0 0 0 0 0 0 0 0 0 0 0 
0 0 0 0 0 0 0 0 0 0 0 0 0 0 0 0 0 0 0 0 0 0 0 0 0 0 0 0 0 0 0 0 0 0 0 0 0 0 0 0 0 0 0 0 0 0 0 0 0 0 
0 0 0 0 0 0 0 0 0 0 0 0 0 0 0 0 0 0 0 0 0 0 0 0 0 0 0 0 0 0 0 0 0 0 0 0 0 0 0 0 0 0 0 0 0 0 0 0 0 0 
0 0 0 0 0 0 0 112 112 112 112 112 112 112 112 112 112 112 112 112 112 112 112 112 112 112 112 112 0 0 0 0 0 0 0 0 0 0 0 0 0 0 0 0 0 0 0 0 0 0 
0 0 0 0 0 0 110 32 32 32 32 32 32 32 32 32 32 32 32 32 32 32 32 32 32 32 32 32 114 112 112 112 0 0 0 0 0 0 0 0 0 0 0 0 0 0 0 0 0 0 
0 0 0 0 0 0 110 32 32 32 32 32 32 32 32 32 32 32 32 32 32 32 32 32 32 32 32 32 32 32 32 32 111 0 112 112 112 112 112 112 112 112 112 112 0 0 0 0 0 0 
0 0 0 0 0 0 110 17 17 17 17 17 17 17 17 17 17 17 17 17 17 17 17 17 17 17 17 17 32 32 32 32 111 110 32 32 32 32 32 32 32 32 32 32 111 0 0 0 0 0 
0 0 0 0 0 0 110 17 17 17 17 17 17 32 32 17 32 32 17 17 17 32 32 17 32 32 17 17 17 17 17 17 111 110 32 32 32 32 121 121 32 32 32 32 111 0 0 0 0 0 
0 0 0 0 0 0 110 17 17 115 117 17 17 17 17 17 17 17 17 17 17 17 17 17 17 17 17 17 17 17 17 17 111 110 32 32 32 32 0 0 32 32 32 32 111 0 0 0 0 0 
0 0 0 0 0 0 110 17 17 111 110 17 17 17 17 17 17 17 17 17 17 17 17 17 17 17 17 17 115 117 17 17 111 110 17 17 17 17 17 17 17 17 17 17 111 0 0 0 0 0 
0 0 0 0 0 0 110 17 17 111 110 17 17 17 17 17 17 17 17 17 17 17 17 17 17 17 17 17 111 110 17 17 111 110 17 17 17 17 17 17 17 17 17 17 111 0 0 0 0 0 
0 0 0 0 0 0 110 17 17 111 110 17 17 17 17 17 17 17 17 17 17 17 17 17 17 17 17 17 111 110 17 17 111 110 17 17 17 17 17 17 17 17 17 17 111 0 0 0 0 0 
0 0 0 0 0 0 110 17 17 111 110 17 17 32 32 17 32 32 17 17 17 32 32 17 32 32 17 17 111 110 17 17 111 110 17 17 17 17 17 17 17 17 17 17 111 0 0 0 0 0 
0 0 0 0 0 0 0 118 118 0 110 17 17 17 17 17 17 17 17 17 17 17 17 17 17 17 17 17 111 110 17 17 111 110 17 17 17 17 17 17 17 17 17 17 111 0 0 0 0 0 
0 0 0 0 0 0 110 32 32 111 110 17 17 17 17 17 17 17 17 17 17 17 17 17 17 17 17 17 111 110 17 17 111 110 17 17 17 17 17 17 17 17 17 17 111 0 0 0 0 0 
0 0 0 0 0 0 110 32 32 111 0 113 113 113 113 113 113 113 113 118 118 118 118 118 118 118 118 118 0 110 17 17 111 110 17 17 17 17 17 17 17 17 17 17 111 0 0 0 0 0 
0 0 0 0 0 0 110 17 17 114 112 112 112 112 0 0 0 0 110 32 32 32 32 32 32 32 32 32 111 110 17 17 111 110 17 17 17 17 17 17 17 17 17 17 111 0 0 0 0 0 
0 0 0 0 0 0 110 17 17 32 32 32 32 32 111 0 0 0 110 32 32 32 32 32 32 32 32 32 111 110 17 17 111 110 17 17 17 17 17 17 17 17 17 17 111 0 0 0 0 0 
0 0 0 0 0 0 110 17 17 32 32 32 32 32 111 0 0 0 110 17 17 17 17 17 17 17 17 17 111 110 17 17 111 110 17 17 17 17 17 17 17 17 17 17 111 0 0 0 0 0 
0 0 0 0 0 0 110 17 17 17 17 17 17 17 111 0 0 0 110 17 17 17 17 17 17 17 17 17 111 110 17 17 111 110 17 17 115 113 113 118 120 17 119 118 0 0 0 0 0 0 
0 0 0 0 0 0 110 17 17 17 17 17 17 17 111 0 112 112 116 17 17 119 118 113 113 117 17 17 111 110 17 17 111 110 17 17 111 0 110 32 32 17 32 32 111 0 0 0 0 0 
0 0 0 0 0 0 110 17 17 17 17 17 17 17 114 116 32 32 32 17 17 32 32 111 0 110 17 17 114 116 17 17 114 116 17 17 111 0 110 32 32 17 32 32 111 0 0 0 0 0 
0 0 0 0 0 0 110 17 17 17 17 17 17 17 32 32 32 32 32 17 17 32 32 111 0 110 17 17 32 32 17 17 32 32 17 17 111 0 110 17 17 17 17 17 111 0 0 0 0 0 
0 0 0 0 0 0 110 17 17 17 17 17 17 17 32 32 17 17 17 17 17 17 17 111 0 110 17 17 32 32 17 17 32 32 17 17 111 0 110 17 17 17 17 17 111 0 0 0 0 0 
0 0 0 0 0 0 110 17 17 17 17 17 17 17 17 17 17 17 17 17 17 17 17 111 0 110 17 17 17 17 17 17 17 17 17 17 111 0 110 17 17 17 17 17 111 0 0 0 0 0 
0 0 0 0 0 0 110 17 17 17 17 17 17 17 17 17 17 17 17 17 17 17 17 114 112 116 17 17 17 17 17 17 17 17 17 17 114 112 112 118 118 118 118 113 0 0 0 0 0 0 
0 0 0 0 0 0 110 17 17 17 17 17 17 17 115 117 17 17 17 17 17 17 17 32 32 32 17 17 17 17 17 17 17 17 17 17 32 32 32 32 32 32 32 111 0 0 0 0 0 0 
0 0 0 0 0 0 0 113 113 113 113 113 113 118 112 112 118 118 118 118 113 113 117 32 32 32 17 17 17 17 17 17 17 17 17 17 32 32 32 32 32 32 32 111 0 0 0 0 0 0 
0 0 0 0 0 0 0 112 112 112 112 112 116 32 32 32 32 32 32 32 111 0 110 17 17 17 17 17 17 17 17 17 17 17 17 17 17 17 17 17 17 17 17 111 0 0 0 0 0 0 
0 0 0 0 0 0 110 32 32 32 32 32 32 32 32 32 32 32 32 32 111 0 110 17 17 17 17 17 17 17 17 17 17 17 17 17 17 17 17 17 17 17 17 111 0 0 0 0 0 0 
0 0 0 0 0 0 110 32 32 32 32 32 32 17 17 17 17 17 17 17 111 0 110 17 17 115 113 113 113 117 17 17 115 113 113 113 118 118 118 118 120 17 17 114 0 0 0 0 0 0 
0 0 0 0 0 0 110 17 17 17 17 17 17 17 17 17 17 17 17 17 114 112 116 17 17 111 0 0 0 110 17 17 111 0 0 110 32 32 32 32 32 17 17 32 111 0 0 0 0 0 
0 0 0 0 0 0 110 17 17 17 17 17 17 17 17 17 17 17 17 17 32 32 32 17 17 111 0 0 0 110 17 17 111 0 0 110 32 32 32 32 32 17 17 32 111 0 0 0 0 0 
0 0 0 0 0 0 110 17 17 115 113 113 117 17 17 17 17 17 17 17 32 32 32 17 17 111 0 0 0 110 17 17 111 0 0 110 17 17 17 17 17 17 17 17 111 0 0 0 0 0 
0 0 0 0 0 0 110 17 17 111 0 0 110 17 17 17 17 17 17 17 17 17 17 17 17 111 0 0 0 110 17 17 111 0 0 110 17 17 17 17 17 17 17 17 111 0 0 0 0 0 
0 0 0 0 0 0 110 17 17 111 0 0 110 17 17 17 17 17 17 17 17 17 17 17 17 114 112 112 112 116 17 17 111 0 0 110 17 32 32 17 17 32 32 17 111 0 0 0 0 0 
0 0 0 0 0 0 110 17 17 114 112 112 112 118 118 118 118 118 118 118 118 118 113 113 117 32 32 32 32 32 17 17 111 0 0 110 17 32 17 17 17 17 32 17 111 0 0 0 0 0 
0 0 0 0 0 0 110 17 17 32 32 32 32 32 32 32 32 32 32 32 32 32 111 0 110 32 32 32 32 32 17 17 111 0 0 110 17 17 17 17 17 17 17 17 111 0 0 0 0 0 
0 0 0 0 0 0 110 17 17 32 32 32 32 32 32 32 32 32 32 32 32 32 111 0 110 17 17 17 17 17 17 17 111 0 0 110 17 17 17 17 17 17 17 17 111 0 0 0 0 0 
0 0 0 0 0 0 110 17 17 17 17 17 17 17 17 17 17 17 17 17 17 17 111 0 110 17 17 17 17 17 17 17 111 0 0 110 17 17 17 17 17 17 17 17 111 0 0 0 0 0 
0 0 0 0 0 0 110 17 17 17 17 17 17 17 17 17 17 17 17 17 17 17 111 0 110 17 17 17 17 17 17 17 111 0 0 110 17 32 17 17 17 17 32 17 111 0 0 0 0 0 
0 0 0 0 0 0 110 17 17 17 32 32 17 17 32 32 17 17 32 32 17 17 111 0 110 17 17 17 17 17 17 17 111 0 0 110 17 32 32 17 17 32 32 17 111 0 0 0 0 0 
0 0 0 0 0 0 110 17 17 17 17 17 17 17 17 17 17 17 17 17 17 17 111 0 110 17 17 17 17 17 17 17 111 0 0 110 17 17 17 17 17 17 17 17 111 0 0 0 0 0 
0 0 0 0 0 0 110 17 17 17 17 17 17 17 17 17 17 17 17 17 17 17 111 0 0 113 113 117 0 115 113 113 0 0 0 0 113 113 113 113 113 113 113 113 0 0 0 0 0 0 
0 0 0 0 0 0 0 113 113 113 113 113 113 113 113 113 113 113 113 113 113 113 0 0 0 0 0 0 121 0 0 0 0 0 0 0 0 0 0 0 0 0 0 0 0 0 0 0 0 0 
0 0 0 0 0 0 0 0 0 0 0 0 0 0 0 0 0 0 0 0 0 0 0 0 0 0 0 0 0 0 0 0 0 0 0 0 0 0 0 0 0 0 0 0 0 0 0 0 0 0 
0 0 0 0 0 0 0 0 0 0 0 0 0 0 0 0 0 0 0 0 0 0 0 0 0 0 0 0 0 0 0 0 0 0 0 0 0 0 0 0 0 0 0 0 0 0 0 0 0 0 
0 0 0 0 0 0 0 0 0 0 0 0 0 0 0 0 0 0 0 0 0 0 0 0 0 0 0 0 0 0 0 0 0 0 0 0 0 0 0 0 0 0 0 0 0 0 0 0 0 0 
0 0 0 0 0 0 0 0 0 0 0 0 0 0 0 0 0 0 0 0 0 0 0 0 0 0 0 0 0 0 0 0 0 0 0 0 0 0 0 0 0 0 0 0 0 0 0 0 0 0 
0 0 0 0 0 0 0 0 0 0 0 0 0 0 0 0 0 0 0 0 0 0 0 0 0 0 0 0 0 0 0 0 0 0 0 0 0 0 0 0 0 0 0 0 0 0 0 0 0 0 
