16 16 16 16 16 16 16 16 16 1 16 16 16 16 16 16 16 1 16 1 16 16 1 16 16 16 16 16 16 16 16 1 16 1 1 16 16 16 16 16 16 16 1 1 1 1 16 16 1 1 
16 16 16 1 16 16 16 16 16 16 16 1 16 16 16 16 16 16 16 16 16 16 16 16 16 16 16 16 16 16 16 16 16 16 16 16 16 16 16 16 1 16 16 16 1 16 1 16 16 1 
16 16 16 16 16 16 16 16 16 16 1 16 16 1 1 16 16 16 16 16 16 16 16 16 16 16 16 16 16 16 16 1 16 16 16 16 16 16 16 16 16 16 16 1 1 1 16 16 16 16 
1 16 16 16 16 16 16 1 16 16 16 16 16 16 16 16 16 16 16 16 16 16 1 16 16 16 1 16 16 16 16 16 16 16 16 16 1 1 16 16 16 16 16 1 1 1 16 1 1 16 
16 16 16 16 16 16 1 16 16 16 1 16 16 16 16 16 16 16 16 16 16 16 16 16 16 16 16 16 16 16 16 16 1 1 16 16 1 16 16 16 1 16 1 16 1 16 16 16 16 1 
1 16 16 1 1 16 16 16 16 16 16 16 16 16 16 16 16 16 16 16 16 16 16 16 16 16 16 16 16 16 1 1 16 16 16 16 16 16 16 16 16 16 16 16 16 1 1 1 1 1 
1 16 16 16 16 16 16 1 16 16 1 16 16 16 16 1 16 16 16 16 16 16 16 16 16 16 16 16 16 16 1 16 16 16 16 16 16 16 16 16 16 16 16 1 16 1 16 16 1 1 
16 16 16 16 16 1 16 16 16 16 16 16 1 16 16 16 1 16 1 16 16 16 16 16 16 16 16 16 16 16 16 16 16 16 1 16 16 16 16 1 16 16 1 16 16 16 16 16 16 1 
16 16 16 16 16 16 16 16 16 16 16 16 16 16 16 16 16 16 16 16 16 16 16 16 16 16 16 16 16 16 16 16 16 16 16 16 16 16 16 16 16 16 16 16 16 16 16 16 16 16 
16 1 16 16 16 16 16 1 16 16 16 16 16 16 16 16 16 16 16 16 16 16 16 16 96 16 16 16 16 16 16 16 16 16 16 16 16 16 16 16 16 16 16 16 16 16 16 16 16 16 
1 16 16 16 16 16 16 16 16 16 1 16 16 16 16 1 1 1 1 1 1 16 16 99 94 86 16 16 1 1 1 1 1 1 1 16 16 16 16 16 16 16 16 16 16 16 16 16 1 16 
16 16 16 16 1 16 16 1 16 16 16 16 1 1 1 1 1 1 1 1 1 1 16 8 3 7 16 1 1 1 1 1 1 1 1 1 16 16 16 16 16 16 1 16 1 1 1 1 1 1 
1 16 16 16 16 16 16 16 16 16 16 16 1 1 1 1 12 10 10 10 10 10 105 106 3 104 105 10 10 10 10 10 10 13 1 1 1 1 16 16 16 16 16 1 1 1 20 21 21 21 
1 16 16 16 16 1 16 16 16 16 16 1 1 12 10 10 11 3 3 3 3 3 3 3 3 3 3 3 3 3 3 3 3 9 10 13 1 1 1 16 16 16 1 20 21 21 31 18 18 18 
16 16 16 16 16 16 16 16 16 16 1 1 1 8 3 3 3 3 3 3 3 3 3 3 3 3 3 3 3 3 3 3 3 3 3 7 1 1 1 1 16 16 1 23 18 18 18 18 18 18 
16 1 16 16 16 16 16 16 16 16 1 1 12 11 3 3 3 3 3 3 3 3 3 3 3 3 3 3 3 3 3 3 3 3 3 9 10 13 1 1 1 16 20 31 18 18 18 18 18 18 
16 1 1 16 16 1 1 16 16 16 1 1 8 3 3 3 3 3 3 3 3 3 3 3 3 3 3 3 3 3 3 3 3 3 3 3 3 7 1 1 1 20 31 18 18 18 18 18 18 18 
16 16 1 1 16 16 16 16 16 16 1 1 8 3 3 3 3 3 3 3 3 3 3 3 3 3 3 3 3 3 3 3 3 3 3 3 3 7 1 1 1 23 18 18 18 18 18 18 18 18 
1 16 16 16 16 16 16 16 16 16 1 1 8 3 3 3 3 3 3 3 3 3 3 3 3 3 3 3 3 3 3 3 3 3 3 3 3 7 1 1 20 31 18 18 18 18 18 18 18 18 
1 16 16 16 16 16 16 16 16 1 1 1 8 3 3 3 3 3 3 3 3 3 3 3 3 3 3 3 3 3 3 3 3 3 3 3 3 7 1 1 23 18 18 18 18 18 18 18 18 18 
16 16 16 1 16 16 16 16 16 1 1 1 8 3 3 3 3 3 3 3 3 3 3 3 3 3 3 3 3 3 3 3 3 3 3 3 3 7 1 1 23 18 18 18 18 18 18 18 18 18 
16 16 16 16 16 16 16 16 16 1 1 1 8 3 3 3 3 3 3 3 3 3 3 3 3 3 3 3 3 3 3 3 3 3 3 3 3 7 1 1 23 18 18 18 18 18 18 18 18 18 
16 16 16 16 16 1 16 1 16 1 1 1 8 3 3 3 3 3 3 3 3 3 3 3 3 3 3 3 3 3 3 3 3 3 3 3 3 7 1 1 23 18 18 18 18 18 18 18 18 18 
16 1 16 1 16 1 16 1 16 1 1 12 11 3 3 3 3 3 3 3 3 3 3 3 3 3 3 3 3 3 3 3 3 3 3 3 3 7 1 1 23 18 18 18 18 18 18 18 18 18 
16 1 16 1 16 16 16 16 16 1 1 8 3 3 3 3 3 3 3 3 3 3 3 3 3 3 3 3 3 3 3 3 3 3 3 3 3 7 1 20 31 18 18 18 18 18 18 18 18 18 
1 1 16 16 16 1 16 16 16 1 1 8 3 3 3 3 3 3 3 3 3 3 3 3 3 3 3 3 3 3 3 3 3 3 3 3 3 7 20 31 18 18 18 18 18 18 18 18 18 18 
1 16 16 16 16 16 16 1 16 1 1 8 3 3 3 3 3 3 3 3 3 3 3 3 3 3 3 3 3 3 3 3 3 3 3 3 3 7 25 26 29 18 18 18 18 18 18 18 18 18 
1 16 16 16 16 16 16 16 16 1 1 8 3 3 3 3 3 3 3 3 3 3 3 3 3 3 3 3 3 3 3 3 3 3 3 3 3 7 1 1 23 18 18 18 18 18 18 18 18 18 
16 16 16 1 16 16 16 16 16 1 1 8 3 3 3 3 3 3 3 3 3 3 3 3 3 3 3 3 3 3 3 3 3 3 3 3 3 7 1 1 23 18 18 18 18 18 18 18 18 18 
1 1 16 16 16 16 1 1 16 1 1 8 3 3 3 3 3 3 3 3 3 3 3 3 3 3 3 3 3 3 3 3 3 3 3 3 3 7 1 1 23 18 18 18 18 18 18 18 18 18 
16 16 16 16 1 16 16 16 16 1 1 8 3 3 3 3 3 3 3 3 3 3 3 3 3 3 3 3 3 3 3 3 3 3 3 3 3 7 1 20 31 18 18 18 18 18 18 18 18 18 
16 1 16 16 1 16 16 16 16 16 1 8 3 3 3 3 3 3 3 3 3 3 3 3 3 3 3 3 3 3 3 3 3 3 3 3 3 7 1 23 18 18 18 18 18 18 18 18 18 18 
1 16 1 16 1 16 16 16 16 16 1 8 3 3 3 3 3 3 3 3 3 3 3 3 3 3 3 3 3 3 3 3 3 3 3 3 3 7 1 23 18 18 18 18 18 18 18 18 18 18 
1 16 16 16 16 1 16 16 16 16 1 14 5 6 3 3 3 3 3 3 3 3 3 3 3 3 3 3 3 3 3 3 3 3 3 3 4 15 1 23 18 18 18 18 18 18 18 18 18 18 
1 16 16 16 16 16 1 16 16 16 1 1 1 8 3 3 3 3 3 3 3 3 3 3 3 3 3 3 3 3 3 3 3 3 3 3 7 1 1 25 29 18 18 18 18 18 18 18 18 18 
16 16 16 16 16 16 1 16 16 1 16 1 1 8 3 3 3 3 3 3 3 3 3 3 3 3 3 3 3 3 3 3 3 3 3 3 7 1 1 1 23 18 18 18 18 18 18 18 18 18 
16 1 16 16 16 16 1 16 16 16 16 1 1 14 5 5 5 5 5 6 3 3 3 3 3 3 3 3 3 3 3 3 3 3 3 3 7 1 1 1 25 29 18 18 18 18 18 18 18 18 
1 1 16 1 1 1 16 16 16 16 16 1 1 1 1 1 1 1 1 14 5 5 5 5 5 5 5 5 5 5 5 5 5 5 5 5 15 1 1 1 16 25 26 26 29 18 18 18 18 18 
1 1 16 1 16 1 1 1 16 16 16 16 16 1 1 1 1 1 1 1 1 1 1 1 1 1 1 1 1 1 1 1 1 1 1 1 1 1 16 16 16 16 1 1 25 26 29 18 18 18 
1 16 16 16 16 16 16 16 16 1 16 16 16 16 16 16 16 16 1 1 1 1 1 1 1 1 1 1 1 1 1 1 1 1 1 16 16 16 16 1 16 16 16 1 1 1 25 26 29 18 
1 16 16 16 1 1 1 16 16 16 16 16 16 1 16 16 16 16 16 16 16 1 16 16 16 1 1 1 16 16 16 16 16 16 16 16 16 16 16 16 16 16 16 1 16 1 1 1 25 26 
16 16 16 16 16 16 16 16 16 16 16 16 16 16 16 16 16 16 16 16 16 16 16 16 16 16 16 16 16 16 16 16 16 16 16 16 16 16 16 16 16 16 16 16 16 16 16 16 16 16 
1 16 1 16 16 16 16 16 16 16 1 1 16 16 16 1 16 16 16 16 16 16 16 1 16 16 16 16 16 16 16 16 16 16 16 16 16 16 1 16 16 16 16 16 16 16 16 16 16 16 
1 16 16 16 16 16 16 16 16 16 16 16 1 16 16 16 16 16 16 16 16 16 16 16 16 16 16 16 16 16 16 16 16 16 16 16 16 16 16 16 16 16 16 16 1 16 16 16 16 16 
1 16 16 1 16 16 16 16 16 16 1 16 16 1 16 16 1 16 16 16 16 16 16 16 16 1 16 16 1 16 16 16 16 16 16 16 16 1 1 16 16 16 16 16 16 16 16 16 16 1 
16 16 16 1 1 16 16 16 16 16 16 16 16 16 16 16 16 16 16 1 1 16 16 16 16 16 16 16 1 16 16 16 16 16 1 1 16 16 1 16 16 16 16 16 16 16 1 16 1 16 
16 16 16 16 16 16 16 16 16 16 16 16 1 16 16 16 16 16 16 16 16 16 16 16 16 16 16 16 16 16 16 16 1 16 16 16 1 16 1 1 16 16 1 16 16 16 16 16 16 1 
16 16 16 16 16 16 16 16 16 16 16 16 16 16 16 16 16 16 16 16 1 16 1 16 16 16 16 16 16 16 1 16 16 16 16 16 16 16 1 16 16 16 16 16 16 16 16 16 16 16 
16 1 16 16 16 16 16 1 16 16 1 16 16 1 16 16 16 16 1 1 16 16 16 16 16 16 16 16 16 16 16 1 1 16 1 16 1 1 16 16 16 16 16 16 16 1 16 16 16 16 
1 1 1 1 1 16 16 16 16 1 16 1 1 1 1 16 1 1 1 16 16 16 1 16 1 1 1 1 16 1 1 16 16 16 16 16 16 1 16 16 16 16 1 16 16 16 1 16 16 16 
