1 16 1 1 16 16 16 1 16 1 16 16 16 16 1 1 16 16 16 1 1 1 1 1 1 16 1 1 1 1 1 1 1 1 16 1 1 1 1 1 1 1 1 1 1 1 1 1 1 1 
16 16 16 1 1 1 16 16 16 16 16 16 16 16 16 16 16 1 16 16 1 16 16 1 1 16 1 1 16 16 16 1 1 1 16 16 16 16 16 1 16 16 16 16 16 16 16 16 16 1 
1 16 1 16 16 16 16 16 16 16 16 16 16 16 16 16 16 16 16 16 16 1 16 16 1 16 1 1 16 16 16 1 16 16 1 1 16 16 16 1 16 16 16 1 16 16 1 16 16 1 
1 16 1 16 16 1 1 16 16 16 16 16 16 16 16 16 16 16 1 16 1 16 16 16 16 1 16 1 16 16 1 16 16 16 1 16 16 16 1 1 16 16 16 1 16 16 16 16 1 16 
1 16 16 16 16 16 16 16 16 16 16 16 16 16 16 16 16 1 16 16 16 16 16 1 16 1 16 16 1 1 16 16 16 16 16 16 16 16 16 16 16 16 16 16 16 16 16 16 16 16 
16 16 16 1 16 16 16 16 16 1 16 16 16 16 16 16 16 16 16 16 16 1 1 16 1 16 1 16 16 1 16 16 1 16 16 16 16 16 16 16 16 16 16 16 16 16 16 16 16 16 
1 16 16 16 16 16 16 16 1 16 16 1 16 1 1 1 1 16 16 16 16 16 16 16 16 16 16 16 16 16 16 1 1 16 16 16 1 1 16 1 1 16 16 16 16 16 16 1 1 1 
1 16 16 16 16 16 16 16 16 1 16 16 16 16 16 16 16 16 16 16 16 16 16 16 16 16 16 16 1 1 16 16 16 16 16 16 16 16 16 16 16 16 16 1 16 16 16 16 1 1 
16 16 16 16 16 16 16 16 16 16 16 16 16 16 16 16 1 1 33 16 16 16 16 16 16 16 16 16 16 16 16 16 1 1 1 1 1 1 1 1 1 16 16 16 16 16 16 16 16 16 
1 16 1 16 16 16 16 16 16 16 1 16 16 16 16 1 1 1 16 16 16 16 16 16 16 1 1 1 1 16 1 1 1 1 1 1 1 1 1 1 1 16 1 1 1 16 1 16 16 1 
1 16 16 1 1 16 16 16 1 1 16 16 16 16 1 1 16 16 16 16 16 16 16 16 1 1 1 1 1 16 1 1 1 1 1 1 1 1 1 1 1 1 16 16 1 16 16 16 1 1 
1 1 1 1 16 16 16 16 16 16 16 16 1 16 16 1 16 16 16 16 1 1 1 1 1 1 1 1 16 16 1 1 1 1 1 1 1 1 1 1 1 16 1 16 1 1 1 16 1 1 
16 16 16 16 16 1 1 16 16 16 16 16 1 16 16 1 16 1 1 1 1 1 1 1 16 16 16 16 16 16 1 1 1 2 1 1 2 1 1 1 1 1 16 16 1 16 16 1 1 1 
16 16 16 16 16 16 16 16 16 16 16 1 16 1 16 1 1 1 1 1 2 1 1 1 16 16 16 16 16 16 1 1 1 1 1 1 1 1 1 1 1 1 16 16 1 16 16 1 16 1 
16 16 1 16 16 16 16 16 16 1 16 1 16 16 16 1 1 1 1 1 1 1 1 16 16 16 16 16 16 16 1 1 1 1 1 1 1 1 1 1 1 1 16 16 16 16 16 16 16 1 
16 1 16 1 16 16 16 1 1 16 16 16 16 16 16 1 1 1 1 1 1 12 94 13 1 1 1 1 1 1 1 1 1 12 94 13 1 1 1 12 94 13 16 16 16 1 16 16 16 1 
16 1 16 1 16 16 16 16 16 1 16 16 1 1 1 1 1 1 2 1 1 8 3 7 1 1 1 1 2 1 1 1 1 8 3 7 1 1 1 8 3 7 1 16 16 16 16 1 1 1 
1 16 16 16 16 1 1 16 16 16 1 16 1 1 1 1 1 1 1 1 1 8 3 7 1 2 1 1 1 1 1 1 1 8 3 7 1 2 1 8 3 7 1 16 16 1 16 16 16 16 
1 16 16 16 16 1 16 1 16 1 16 1 1 1 1 1 1 1 1 1 1 8 3 7 1 1 1 1 1 1 1 1 2 8 3 7 1 1 1 8 3 7 1 16 16 16 1 16 16 1 
1 16 16 16 16 1 16 16 16 1 16 16 16 16 16 16 16 16 16 16 16 8 3 9 10 10 10 10 10 10 10 10 10 11 3 9 10 10 10 11 3 7 1 16 16 16 1 16 1 1 
1 16 1 1 1 1 1 16 16 1 16 1 1 1 1 1 1 1 2 1 16 8 3 3 3 3 3 3 3 3 3 3 3 3 3 3 3 3 3 3 3 7 1 16 1 16 1 1 1 1 
1 1 1 1 1 1 1 16 16 1 16 1 1 1 1 1 1 1 1 2 16 14 5 6 3 3 3 3 3 3 3 3 3 3 3 3 3 3 3 3 3 7 1 16 16 1 16 16 16 1 
1 1 1 1 1 1 1 16 16 1 16 1 1 2 1 1 1 1 1 1 16 1 12 11 3 3 3 4 5 5 5 5 5 5 5 5 5 5 6 3 3 7 1 16 16 16 1 16 1 1 
1 1 1 1 1 1 1 16 16 1 16 1 1 1 2 1 1 1 1 1 1 1 8 3 3 4 5 15 1 1 1 1 1 1 1 1 1 1 8 3 3 7 1 16 1 1 1 16 1 1 
1 1 1 1 1 1 1 16 16 1 16 1 1 1 1 1 1 1 1 1 1 1 8 3 3 7 1 1 1 1 1 1 1 1 1 1 1 1 8 3 3 7 1 16 16 16 1 16 1 1 
1 1 1 12 94 13 1 16 16 1 16 1 1 1 1 12 94 13 1 1 2 2 8 3 3 7 1 1 1 1 1 1 1 1 1 1 1 1 8 3 3 7 1 16 16 1 16 16 16 16 
1 1 1 8 3 7 1 16 16 1 16 1 1 1 1 8 3 7 1 1 1 1 8 3 3 7 1 1 1 20 21 21 21 21 21 22 1 1 8 3 3 7 1 16 16 16 16 16 1 16 
1 1 2 8 3 7 1 1 16 12 10 10 10 10 10 11 3 9 10 10 10 10 11 3 3 7 1 1 1 23 19 18 18 18 18 24 1 1 8 3 3 7 1 16 16 16 16 16 1 16 
10 10 10 11 3 9 10 10 105 11 3 3 3 3 3 3 3 3 3 3 3 3 3 3 3 7 1 1 1 23 18 18 19 19 18 24 1 1 8 3 3 7 1 16 16 16 1 16 1 1 
3 3 3 3 3 3 3 3 3 3 3 3 3 3 3 3 3 3 3 3 3 3 3 3 3 7 1 1 1 25 29 19 18 18 28 27 1 1 8 3 3 7 1 16 16 16 16 16 1 1 
5 5 5 5 5 5 5 5 102 5 5 5 5 5 5 5 5 5 5 5 5 5 6 3 3 7 1 1 1 1 25 26 26 26 27 1 1 1 8 3 3 7 1 16 16 16 16 16 16 16 
16 16 16 16 16 16 16 1 16 1 1 1 1 1 1 1 1 1 1 1 1 2 8 3 3 7 1 1 1 1 1 1 1 1 1 1 1 1 8 3 3 7 1 16 16 16 16 1 1 1 
16 16 16 1 1 1 16 1 16 1 1 1 1 2 1 1 1 1 2 1 1 2 8 3 3 7 1 1 1 1 1 1 1 1 1 1 1 1 8 3 3 7 1 16 16 16 16 16 16 1 
16 16 16 1 16 16 16 1 16 1 1 1 1 1 1 1 1 1 1 1 1 1 14 6 3 9 10 10 10 10 10 10 10 10 10 10 10 10 11 3 3 7 1 16 16 1 16 1 16 1 
16 16 1 16 16 16 16 16 16 1 1 1 1 1 1 1 1 20 21 22 1 1 2 8 3 3 3 3 3 3 3 3 3 3 3 3 3 3 3 3 3 7 1 16 16 16 16 16 16 1 
1 16 16 16 1 1 1 1 1 20 21 21 21 21 21 21 21 31 18 24 1 1 1 8 3 3 3 3 3 3 3 3 3 3 3 3 3 3 3 3 4 15 1 16 16 16 16 16 16 1 
16 16 16 1 1 20 21 21 21 31 18 18 18 18 18 18 18 18 28 27 1 1 1 14 5 6 3 4 5 5 5 5 5 5 6 3 4 5 5 5 15 1 16 16 16 16 16 1 16 1 
16 16 16 16 1 25 29 18 18 18 18 18 18 18 18 18 18 28 27 1 1 1 1 16 16 91 93 87 16 16 1 1 16 16 91 93 87 16 16 16 16 16 1 1 16 16 1 16 16 1 
1 1 1 1 1 1 23 18 18 18 18 18 18 18 18 18 18 30 22 1 1 1 1 16 1 1 1 1 1 16 1 1 16 1 1 1 1 1 1 1 1 16 16 16 16 16 16 16 1 1 
1 1 1 1 1 1 23 18 18 18 18 18 18 28 26 26 26 26 27 1 1 1 1 16 1 1 1 1 1 16 1 1 16 1 1 1 1 1 1 1 1 16 1 16 16 16 16 16 16 16 
1 1 1 1 1 1 23 18 18 18 18 18 18 27 1 1 1 1 1 1 1 1 1 16 1 1 1 1 1 16 1 1 16 1 1 1 1 1 1 1 1 16 1 16 16 16 1 16 1 16 
1 1 1 1 1 1 23 18 18 18 18 28 27 1 1 1 1 16 1 16 16 1 16 1 1 1 1 1 1 16 1 1 16 1 1 1 1 1 1 1 1 16 16 16 16 16 16 1 16 1 
1 1 1 1 1 1 23 18 18 18 18 24 1 1 1 16 16 16 1 1 16 16 16 1 1 1 1 1 1 16 1 1 16 1 1 1 1 1 1 1 1 1 16 16 16 1 16 16 16 16 
1 1 1 1 1 20 31 18 18 18 18 24 1 1 1 1 16 16 16 16 16 16 16 1 1 1 1 1 1 16 16 16 1 1 1 1 1 1 1 1 1 1 16 16 16 16 16 1 16 1 
20 21 21 21 21 31 18 18 18 18 18 24 16 16 16 16 16 16 16 16 16 16 16 1 1 1 1 1 1 1 1 16 1 1 1 1 1 1 1 1 1 1 16 16 16 16 16 16 1 1 
31 18 18 18 18 18 19 18 18 18 18 30 22 16 1 1 16 16 1 16 1 16 16 1 1 1 1 1 1 1 1 16 1 1 1 1 1 1 1 1 1 1 1 1 16 16 16 16 16 16 
18 19 18 18 18 18 18 18 18 18 19 18 30 22 1 1 1 1 1 1 16 1 16 1 1 1 1 1 1 1 1 16 16 16 1 1 1 1 1 1 1 1 1 1 16 16 16 16 16 1 
18 18 18 18 18 18 18 18 18 18 18 18 18 30 21 21 21 22 1 1 1 16 16 16 16 16 16 16 16 16 16 16 1 16 1 1 1 1 1 1 1 16 16 16 16 16 16 16 16 1 
18 18 18 19 19 18 18 18 18 18 18 18 18 18 18 19 18 24 1 1 1 16 1 16 16 16 16 1 16 1 16 16 1 1 16 16 16 16 16 1 16 16 1 16 16 16 16 16 16 16 
18 18 18 18 18 18 18 18 18 18 18 18 18 18 18 18 18 24 1 1 1 1 1 1 1 16 16 16 1 1 1 1 1 1 16 1 16 1 16 16 16 1 1 16 1 1 16 16 16 16 
