1 16 1 1 16 16 16 1 16 1 16 16 16 16 1 1 16 16 16 1 1 1 1 1 1 16 1 1 1 1 1 1 1 1 16 1 1 1 1 1 1 1 1 1 1 1 1 1 1 1 
16 16 16 1 1 1 16 16 16 16 16 16 16 16 16 16 16 1 16 16 1 16 16 1 1 16 1 1 16 16 16 1 1 1 16 16 16 16 16 1 16 16 16 16 16 16 16 16 16 1 
1 16 1 16 16 16 16 16 16 16 16 16 16 16 16 16 16 16 16 16 16 1 16 16 1 16 1 1 16 16 16 1 16 16 1 1 16 16 16 1 16 16 16 1 16 16 1 16 16 1 
1 16 1 16 16 1 1 16 16 16 16 16 16 16 16 16 16 16 1 16 1 16 16 16 16 1 16 1 16 16 1 16 16 16 1 16 16 16 1 1 16 16 16 1 16 16 16 16 1 16 
1 16 16 16 16 16 16 16 16 16 16 16 16 16 16 16 16 1 16 16 16 16 16 1 16 1 16 16 1 1 16 16 16 16 16 16 16 16 16 16 16 16 16 16 16 16 16 16 16 16 
16 16 16 1 16 16 16 16 16 1 16 16 16 16 16 16 16 16 16 16 16 1 1 16 1 16 1 16 16 1 16 16 1 16 16 16 16 16 16 16 16 16 16 16 16 16 16 16 16 16 
1 16 16 16 16 16 16 16 1 16 16 1 16 1 1 1 1 16 16 16 16 16 16 16 16 16 16 16 16 16 16 1 1 16 16 16 1 1 16 1 1 16 16 16 16 16 16 1 1 1 
1 16 16 16 16 16 16 16 16 1 16 16 16 16 16 16 16 16 16 16 16 16 1 16 16 16 16 16 1 1 16 16 16 16 16 96 16 16 16 16 16 16 16 1 16 16 16 16 1 1 
16 16 16 16 16 16 16 16 16 16 16 16 16 1 16 1 1 1 1 1 1 16 16 16 16 16 16 16 16 16 16 16 16 16 99 94 86 16 1 1 16 16 1 16 1 16 16 16 16 16 
16 16 16 16 16 16 16 16 16 16 16 16 16 1 1 1 1 1 1 1 1 1 1 1 1 1 1 1 1 1 1 1 1 1 8 3 9 10 10 13 16 16 16 1 16 1 1 16 16 1 
16 16 16 16 16 16 16 16 16 1 1 1 1 1 1 1 1 1 1 1 1 1 1 1 1 1 1 1 1 1 12 10 10 10 11 3 3 3 3 7 16 16 16 16 16 16 16 1 16 16 
16 16 16 16 16 16 16 16 99 10 10 10 10 10 10 10 10 10 10 10 10 10 10 10 10 10 10 10 10 10 11 3 3 3 3 3 3 3 3 7 16 16 16 16 16 16 16 16 16 16 
16 16 16 16 16 16 16 98 92 3 3 3 3 3 3 3 3 3 3 3 3 3 3 3 3 3 3 3 3 3 3 3 3 3 3 3 3 3 3 7 16 16 16 16 16 16 16 16 16 16 
16 16 16 1 16 16 16 16 91 5 5 5 102 102 5 5 102 5 5 6 3 4 5 5 5 102 5 5 6 3 3 3 3 3 3 3 3 3 3 7 16 16 16 16 16 16 16 16 16 16 
16 16 16 16 16 16 16 16 16 16 16 16 16 16 1 16 16 1 16 8 3 7 1 16 16 16 16 16 8 3 3 3 3 3 3 3 3 3 3 7 16 16 16 16 16 16 1 16 16 16 
16 16 16 16 16 16 16 16 1 16 16 16 16 16 16 16 16 16 16 8 3 7 16 16 16 16 16 16 8 3 3 3 3 3 3 3 3 3 3 7 16 16 16 1 16 16 16 16 1 1 
16 16 16 16 16 16 16 16 1 16 1 1 1 1 1 16 16 16 1 8 3 7 16 1 1 1 16 16 8 3 3 3 3 3 3 3 3 3 3 7 16 16 16 16 1 16 16 16 16 1 
16 1 16 16 16 16 16 16 16 16 1 1 1 1 1 1 16 16 16 8 3 7 16 1 1 1 16 1 8 3 3 3 3 3 3 3 3 3 3 7 16 16 16 16 16 16 16 16 1 16 
1 1 16 16 1 1 16 16 1 16 1 16 1 1 1 1 16 16 1 8 3 7 1 16 1 16 16 16 14 5 6 3 3 4 5 5 5 6 3 7 16 16 16 16 1 16 1 16 1 16 
1 16 16 16 16 16 16 16 16 16 1 1 1 1 1 1 16 16 16 8 3 7 1 16 1 16 16 16 16 16 8 3 4 15 1 1 1 14 5 15 16 16 16 16 16 16 1 16 1 1 
1 16 1 16 16 1 16 16 16 16 1 1 1 16 1 1 16 16 1 8 3 7 1 16 1 16 16 16 16 1 8 3 7 1 1 1 1 1 1 1 16 16 16 16 1 1 16 16 16 16 
1 16 1 16 16 16 16 16 16 16 1 1 1 1 1 1 16 16 16 8 3 7 1 1 1 16 16 1 1 1 8 3 7 1 1 1 16 16 1 16 16 1 16 16 1 16 1 16 16 16 
1 16 1 16 1 1 16 16 16 16 1 1 1 1 1 1 16 16 16 8 3 9 10 10 10 10 10 10 10 10 11 3 7 1 1 1 1 16 16 16 16 16 16 16 16 16 16 16 16 1 
16 16 16 16 1 16 16 16 1 16 1 1 1 1 1 1 16 16 1 8 3 3 3 3 3 3 3 3 3 3 3 3 7 1 1 16 1 1 1 16 16 16 16 1 16 16 16 16 16 16 
1 1 16 16 1 1 16 16 16 16 1 1 1 1 1 1 16 16 1 8 3 4 5 5 5 5 5 5 5 5 5 5 15 1 16 16 16 16 16 1 1 16 16 16 16 1 1 1 16 16 
16 16 1 16 16 1 1 16 1 16 1 1 1 16 16 16 16 16 16 8 3 7 16 16 16 16 1 1 1 16 1 16 16 16 1 16 16 1 1 1 1 16 16 20 21 21 21 21 21 21 
16 1 1 16 1 1 1 16 16 16 1 1 16 16 16 16 16 16 16 8 3 7 16 16 16 2 16 1 1 16 16 16 1 1 16 16 1 16 16 1 1 16 16 25 29 18 18 18 18 18 
1 16 1 16 1 16 1 16 16 16 1 1 16 16 16 16 16 16 16 8 3 7 16 16 16 1 16 16 16 16 16 1 1 1 1 1 1 1 1 16 16 16 16 16 23 18 18 18 18 18 
1 16 16 1 16 16 16 16 16 16 1 1 16 1 16 16 16 16 16 8 3 7 16 16 1 1 16 16 16 16 1 1 1 16 1 1 1 1 1 16 16 1 16 16 25 26 26 26 26 26 
16 16 16 1 16 16 1 16 16 16 1 1 1 1 16 16 16 16 1 8 3 7 1 16 1 1 1 1 16 1 1 16 16 16 16 16 16 1 1 1 1 1 1 1 1 16 16 1 16 1 
16 1 1 1 16 16 1 16 1 16 1 1 1 16 1 16 16 16 1 8 3 7 1 16 1 2 1 2 1 1 1 16 16 16 16 16 16 1 1 16 16 16 16 16 16 1 16 16 16 16 
1 1 73 75 16 1 1 16 16 16 1 1 1 1 16 16 16 16 1 8 3 7 1 16 1 1 1 1 1 16 16 16 16 16 16 16 16 1 1 16 16 16 16 16 16 16 16 16 1 16 
74 74 84 77 1 16 1 16 16 16 16 1 1 16 1 16 16 16 1 8 3 7 1 16 16 16 16 1 16 16 16 16 16 16 16 16 16 1 1 16 16 16 16 16 16 16 16 16 16 16 
17 17 17 77 16 16 16 16 16 16 16 1 1 1 1 16 16 16 16 8 3 7 16 16 16 1 16 16 16 16 1 16 16 16 1 16 16 1 1 16 16 16 16 1 1 1 1 1 16 16 
17 17 17 83 74 75 16 73 75 16 16 16 1 1 1 16 16 16 16 8 3 7 1 16 16 16 16 1 16 16 16 1 1 16 16 1 1 1 1 1 1 1 1 1 2 1 1 2 16 16 
17 17 17 17 17 83 74 84 77 16 16 16 1 1 1 16 16 16 1 8 3 7 1 16 16 16 1 16 16 16 1 1 1 1 12 94 13 2 1 1 12 94 13 1 1 1 1 1 16 16 
17 17 17 17 17 17 17 17 77 16 99 10 10 10 10 10 10 10 10 11 3 9 10 10 10 10 10 10 10 10 105 10 10 10 11 3 9 10 10 105 106 3 104 105 105 105 105 105 105 10 
90 90 17 17 90 90 90 90 100 101 92 3 3 3 3 3 3 3 3 3 3 3 3 3 3 3 3 3 3 3 3 3 3 3 3 3 3 3 3 3 3 3 3 3 3 3 3 3 3 3 
17 17 17 17 17 17 17 17 77 16 91 5 5 5 5 102 5 5 5 5 5 5 5 5 5 5 5 102 5 5 102 102 102 107 3 103 102 102 102 102 102 5 5 6 3 4 5 5 5 5 
17 17 81 79 17 17 17 81 80 16 16 16 1 16 16 1 16 1 1 1 1 1 1 1 16 16 1 1 1 16 1 16 1 14 93 15 1 1 1 1 16 1 16 91 93 87 16 16 16 16 
17 81 80 16 76 17 81 80 16 16 16 16 16 1 16 16 16 1 16 16 16 16 16 16 16 1 16 16 16 1 1 16 1 1 1 1 1 1 2 1 16 1 16 1 1 1 1 16 16 16 
17 77 16 16 78 79 80 16 16 16 16 16 16 16 1 16 16 16 16 16 16 16 16 1 16 16 16 16 16 16 16 16 1 1 1 1 1 1 1 1 16 1 16 1 1 1 1 16 16 16 
79 80 16 16 16 1 16 16 16 16 16 16 16 16 16 16 1 16 16 16 1 16 16 16 1 16 16 16 1 16 16 16 16 1 1 1 1 1 1 16 16 1 16 1 1 1 1 16 1 16 
16 16 16 1 16 16 16 16 16 16 16 16 16 1 16 16 16 16 16 16 16 1 1 16 16 16 16 16 16 16 16 1 16 16 16 16 16 16 16 16 16 1 16 1 1 1 1 16 1 16 
20 21 21 21 21 21 21 21 21 21 21 22 16 16 16 16 16 16 1 1 16 1 16 16 1 16 16 16 1 16 1 16 16 16 16 16 16 16 16 16 16 16 16 1 1 1 1 1 16 16 
31 18 18 18 18 18 19 18 18 18 18 30 22 16 1 16 16 16 16 16 16 16 16 16 16 16 1 1 16 1 16 16 16 16 1 16 16 16 16 16 16 1 16 16 16 16 16 16 1 16 
18 19 18 18 18 18 18 18 18 18 19 18 30 22 1 1 1 1 16 1 16 1 16 1 1 16 16 1 1 16 16 16 1 16 1 16 1 16 1 16 16 1 16 16 1 1 16 16 1 1 
18 18 18 18 18 18 18 18 18 18 18 18 18 30 21 21 21 21 22 16 16 16 1 16 16 16 16 1 16 16 16 16 16 16 16 16 16 16 16 16 16 16 16 16 16 16 16 2 16 16 
18 18 18 19 19 18 18 18 18 18 18 18 18 18 18 19 18 18 24 16 16 16 1 16 16 16 16 16 16 16 1 16 16 16 16 16 1 16 1 16 16 16 16 16 16 16 16 2 16 16 
18 18 18 18 18 18 18 18 18 18 18 18 18 18 18 18 18 18 24 16 16 16 16 16 16 16 16 16 16 16 16 16 16 1 16 16 16 16 16 16 16 16 16 16 16 16 16 16 16 16 
