1 1 16 1 16 1 16 1 16 16 16 1 1 16 1 16 32 32 32 32 32 32 32 32 32 32 32 32 32 32 32 32 32 32 32 32 32 32 32 32 32 32 32 32 32 32 32 32 32 32 
1 1 16 16 16 1 16 16 16 16 16 16 1 16 16 1 32 32 32 32 32 32 32 32 32 32 32 32 32 32 32 32 32 32 32 32 32 32 32 32 32 32 32 32 32 32 32 32 32 32 
1 1 16 16 16 16 16 16 16 1 1 16 16 16 16 1 32 32 32 32 32 32 32 32 32 32 32 32 32 32 32 32 32 32 32 32 32 32 32 32 32 32 32 32 32 32 32 32 32 32 
1 1 16 16 16 16 16 16 1 16 16 1 16 16 16 16 32 32 32 32 32 32 32 32 32 32 32 32 32 32 32 32 32 32 32 32 32 32 32 32 32 32 32 32 32 32 32 32 32 32 
1 1 1 1 16 16 1 16 1 1 16 16 1 16 1 16 32 32 32 32 32 32 32 32 32 32 32 32 32 32 32 32 32 32 32 32 32 32 32 32 32 32 32 32 32 32 32 32 32 32 
1 1 1 16 16 16 16 16 1 16 16 16 1 16 16 16 32 32 32 32 32 32 32 32 32 32 32 32 32 32 32 32 32 32 32 32 32 32 32 32 32 32 32 32 32 32 32 32 32 32 
1 1 16 16 16 1 16 16 16 16 1 16 16 1 16 16 32 32 32 32 32 32 32 32 32 32 32 32 32 32 32 32 32 32 32 109 48 108 32 32 32 32 32 32 32 32 32 32 32 32 
1 1 16 16 16 16 16 16 16 16 16 16 16 16 16 16 32 32 32 32 32 32 32 32 32 32 32 32 32 32 32 32 32 32 32 50 0 49 32 32 32 32 32 32 32 32 32 32 32 32 
1 1 1 1 1 16 1 16 16 1 16 16 16 16 1 16 32 32 32 32 32 32 32 32 32 32 32 32 32 32 32 32 32 32 32 50 0 49 32 32 32 32 32 32 32 32 32 32 32 32 
1 1 16 16 16 1 16 16 16 16 16 16 16 16 16 16 16 16 16 16 99 105 105 105 105 10 13 1 1 16 16 16 16 16 16 12 94 13 1 16 16 16 16 16 16 16 16 16 16 16 
1 1 16 16 1 16 16 16 16 16 16 16 16 1 16 12 10 10 10 10 11 3 3 3 3 3 9 10 13 1 1 16 16 16 12 11 3 9 13 16 16 16 16 16 16 16 16 16 16 16 
1 1 1 16 16 16 1 16 16 16 16 16 16 16 12 11 3 3 3 3 3 3 3 3 3 3 3 3 9 10 10 10 10 10 11 3 3 3 7 16 16 16 16 16 16 16 16 16 16 16 
1 1 16 1 16 16 16 16 16 16 16 16 1 1 8 3 3 3 3 3 3 3 3 3 3 3 3 3 3 3 3 3 3 3 3 3 3 3 7 1 16 16 16 16 16 16 16 16 16 16 
1 1 16 16 16 1 16 16 16 16 1 1 1 1 8 3 3 3 3 3 3 3 3 3 3 3 3 3 4 5 102 5 102 5 6 3 3 3 7 1 16 16 16 16 16 16 16 16 16 16 
1 1 16 16 16 16 1 16 16 16 16 1 1 1 14 6 3 3 3 3 3 3 3 3 3 3 3 3 7 1 16 16 16 16 14 6 3 4 15 16 16 16 16 1 16 16 16 16 1 1 
1 1 16 16 16 16 16 16 16 1 16 1 1 1 1 8 3 3 3 3 3 3 3 3 3 3 3 3 7 1 16 16 16 16 16 8 3 7 16 16 16 16 16 16 16 16 16 16 1 16 
1 16 16 16 16 16 16 16 16 16 16 16 1 1 1 8 3 3 3 3 3 3 3 3 3 3 3 3 7 1 16 16 16 16 16 8 3 7 16 16 16 16 16 16 16 16 16 16 16 16 
1 16 1 16 1 16 16 16 16 16 16 16 1 1 1 14 6 3 3 3 3 3 3 3 3 3 3 3 7 16 16 16 1 12 10 11 3 9 10 13 16 16 16 16 16 16 16 16 1 1 
16 16 16 16 16 16 16 16 16 16 16 16 16 1 16 1 14 5 6 3 3 3 3 3 3 3 3 3 7 16 16 16 16 8 3 3 3 3 3 7 16 16 16 16 16 16 1 16 1 1 
1 1 16 1 16 16 1 16 16 16 16 16 16 16 16 16 1 1 14 5 5 6 3 4 5 102 102 102 87 16 16 16 1 8 3 3 3 3 3 7 16 16 16 16 16 16 16 16 16 1 
1 16 16 1 16 16 16 16 16 16 16 16 16 1 16 16 16 16 1 1 1 8 3 7 1 16 16 16 16 16 1 1 12 11 3 3 3 3 3 7 16 16 16 16 16 16 16 16 1 16 
1 16 16 16 16 16 16 16 16 16 1 16 16 16 16 16 16 16 16 16 16 8 3 9 10 10 10 10 10 10 10 10 11 3 3 3 3 3 3 7 16 16 16 16 16 16 16 16 1 16 
1 16 16 16 1 16 1 16 16 16 1 1 1 1 1 16 16 16 16 16 16 8 3 3 3 3 3 3 3 3 3 3 3 3 3 3 3 3 3 7 16 16 16 16 16 16 16 16 16 1 
16 16 16 16 16 1 16 16 16 16 12 10 10 10 10 13 1 16 16 16 16 8 3 4 5 5 5 5 5 5 5 5 5 6 3 3 3 3 3 7 16 16 16 16 16 16 16 16 16 1 
1 16 16 16 16 16 16 16 16 16 8 3 3 3 3 9 13 1 1 1 1 8 3 7 1 1 16 16 1 1 1 1 1 8 3 3 3 3 3 7 16 16 16 16 16 1 1 16 16 16 
1 16 16 1 16 16 16 16 16 16 8 3 3 3 3 3 9 10 10 10 10 11 3 7 1 16 16 16 16 16 1 1 1 14 5 5 5 5 5 15 16 16 16 16 1 16 16 16 1 16 
1 16 16 16 16 1 16 16 16 16 8 3 3 3 3 3 3 3 3 3 3 3 3 7 16 16 16 16 16 16 16 16 16 16 1 1 1 1 1 16 16 16 16 1 16 16 16 1 1 1 
1 16 16 16 1 16 16 16 16 16 8 3 3 3 3 4 5 5 5 5 5 6 3 7 16 16 16 16 16 16 16 16 16 16 16 1 16 16 16 16 16 16 16 16 16 1 16 1 16 1 
16 16 16 1 16 1 16 16 16 16 8 3 3 3 4 15 1 16 16 16 1 8 3 7 1 1 16 16 16 16 16 16 16 16 16 16 16 16 16 16 16 16 16 16 16 16 1 16 16 1 
16 16 16 1 16 16 16 16 16 16 14 5 5 5 15 16 16 16 16 16 1 8 3 7 1 1 1 1 1 1 16 16 16 16 16 1 1 1 16 16 16 16 16 16 16 16 16 16 1 1 
16 16 16 16 16 16 1 16 16 16 16 1 1 16 16 16 16 16 16 16 1 8 3 9 10 10 10 10 10 10 10 10 10 10 10 10 10 13 1 1 16 16 16 16 16 16 16 16 16 1 
16 16 16 16 16 16 16 16 16 16 16 1 1 16 16 16 16 16 16 16 16 8 3 3 3 3 3 3 3 3 3 3 3 3 3 3 3 9 10 13 16 16 16 16 16 16 1 16 16 1 
16 1 16 16 16 16 1 16 16 16 16 16 1 16 16 16 16 16 16 16 1 8 3 4 5 5 5 5 5 5 5 5 6 3 3 3 3 3 3 7 16 16 16 1 16 16 1 16 16 1 
16 16 16 16 16 16 16 16 16 16 16 16 1 16 16 16 16 16 16 16 16 8 3 7 1 1 1 16 16 1 1 12 11 3 3 3 3 3 3 7 16 16 16 16 16 16 16 1 16 1 
16 16 16 1 16 16 16 16 16 16 1 1 1 1 1 1 16 16 16 16 1 8 3 7 1 16 16 16 16 16 1 8 3 3 3 3 3 3 3 7 16 16 16 16 1 16 1 16 16 16 
1 16 16 16 16 16 16 16 16 16 1 1 1 1 1 1 16 16 16 16 16 8 3 7 1 16 16 16 16 16 1 8 3 3 3 3 3 3 3 7 16 16 16 1 16 16 16 1 16 1 
1 16 16 1 16 16 1 16 16 16 1 1 1 1 1 1 1 16 16 16 1 8 3 7 1 16 16 16 16 16 1 14 6 3 3 3 3 3 4 15 16 16 16 16 16 16 1 1 16 1 
16 16 16 16 16 16 1 16 16 16 1 1 1 1 1 1 1 16 16 16 16 8 3 7 1 16 16 16 16 16 16 1 14 5 5 5 5 5 15 1 16 16 16 16 16 16 16 16 1 1 
16 16 16 16 16 16 1 16 16 16 1 1 1 1 1 1 16 16 16 16 16 8 3 7 1 16 16 16 16 16 16 16 1 1 1 1 1 1 1 1 16 16 16 16 16 16 16 16 1 1 
16 1 16 16 16 16 16 16 16 16 1 1 1 1 1 1 16 16 16 16 1 8 3 7 16 16 16 16 16 16 16 1 16 16 1 1 1 1 1 1 16 16 16 16 16 16 16 16 1 16 
1 16 16 16 1 16 16 16 16 16 1 1 1 1 16 16 16 16 16 16 16 91 93 87 16 16 1 16 16 16 16 16 16 16 16 1 1 1 1 16 16 16 16 16 16 16 16 16 16 16 
16 16 16 16 16 16 16 16 16 16 16 1 1 1 16 16 16 16 16 16 16 16 95 16 16 16 16 16 16 16 16 16 16 16 16 16 16 16 16 16 16 1 16 1 16 16 16 1 16 1 
16 16 1 16 16 16 16 16 16 16 16 16 16 16 16 16 16 16 16 16 16 16 16 16 16 16 16 16 16 16 16 16 16 16 16 16 16 16 16 16 16 16 16 16 16 16 16 1 16 16 
1 16 16 16 16 1 16 1 16 16 16 16 16 1 16 16 16 16 1 16 16 16 1 16 16 1 1 16 16 1 16 16 16 16 1 16 16 16 16 1 1 1 16 1 16 16 16 16 16 1 
16 16 16 16 16 1 16 16 16 16 1 16 16 16 16 16 16 16 16 1 16 16 16 16 16 16 16 16 1 16 16 16 16 16 16 16 16 16 16 16 16 16 1 16 16 16 16 16 1 1 
16 1 16 16 16 1 16 16 16 1 16 16 16 16 1 16 1 16 16 16 16 16 16 1 16 16 16 16 16 16 1 16 16 16 16 16 1 16 16 16 16 16 16 16 16 16 16 16 16 16 
16 1 16 16 16 16 16 16 1 16 16 16 16 1 16 16 16 16 16 16 16 16 16 16 16 16 1 16 1 16 16 16 16 16 16 16 16 16 1 1 16 16 16 1 1 16 16 16 1 16 
16 1 16 16 16 16 16 16 16 16 16 16 16 16 16 16 16 1 16 1 16 16 16 16 16 16 16 1 16 16 16 16 16 1 16 16 16 16 16 16 16 1 16 16 16 16 1 16 16 16 
1 16 16 16 16 1 1 16 16 16 1 16 16 16 16 1 16 16 1 1 16 16 16 16 16 16 16 16 16 16 16 1 16 1 16 1 16 1 16 16 16 1 16 16 16 16 16 16 16 1 
1 16 1 1 16 16 16 1 16 16 1 16 1 1 1 1 1 16 1 16 16 16 16 16 16 1 16 16 16 16 1 1 1 16 16 1 16 1 16 1 1 1 1 16 16 1 16 16 16 1 
