16 16 16 16 16 16 16 16 16 16 16 16 16 16 16 16 16 16 16 16 16 16 16 16 16 16 16 16 16 16 16 16 16 16 16 16 16 16 16 16 16 16 16 16 16 16 16 16 16 16 
16 16 16 16 16 16 16 16 16 16 16 16 16 16 16 16 16 16 16 16 16 16 73 75 16 16 73 74 74 75 16 16 16 16 73 75 16 16 16 16 16 16 16 16 16 16 16 73 75 16 
16 16 16 16 16 16 16 16 16 73 74 74 74 74 74 74 74 74 75 16 16 73 84 83 74 74 84 17 17 83 75 16 73 74 84 83 74 74 74 74 75 16 16 16 16 16 73 84 83 75 
74 74 75 16 16 16 16 16 73 84 17 17 17 81 79 79 79 79 80 16 16 78 79 79 82 17 17 17 17 81 80 16 78 79 79 79 79 82 17 17 83 75 16 16 16 16 78 79 79 80 
17 17 77 16 16 16 16 16 78 79 82 17 81 80 16 16 16 16 16 16 16 16 16 16 78 79 79 79 79 80 16 16 16 16 16 16 16 78 79 79 79 80 16 16 16 16 16 16 16 16 
17 17 77 16 16 16 16 16 16 16 78 79 80 16 16 16 16 16 16 16 16 16 16 16 16 16 16 16 16 16 16 16 16 16 16 16 16 16 16 16 16 16 16 16 16 16 73 74 74 74 
17 17 83 75 16 16 16 16 16 16 16 16 73 74 74 74 74 75 16 16 16 16 16 73 74 74 74 75 16 16 16 16 16 16 16 16 16 16 16 16 16 16 16 16 16 73 84 17 17 17 
17 17 17 77 16 16 16 16 16 16 73 74 84 17 17 17 17 83 74 74 74 74 74 84 17 17 17 83 74 74 74 74 74 74 74 74 74 74 74 74 74 75 16 16 73 84 17 17 17 17 
90 90 17 100 101 16 16 16 16 88 89 90 17 17 17 17 90 90 17 90 90 90 17 90 90 90 90 90 90 17 17 90 17 17 90 17 90 90 90 90 17 100 101 88 89 90 90 90 90 90 
17 17 17 77 16 16 16 16 16 16 76 17 17 17 17 17 17 17 17 17 17 17 17 17 17 17 17 17 17 17 17 17 17 17 17 17 17 17 17 17 81 80 16 16 78 79 79 79 79 79 
17 17 81 80 16 16 16 16 16 16 76 17 17 17 17 17 17 17 17 81 79 82 17 17 17 17 17 17 17 17 17 17 17 17 17 17 17 17 17 17 77 16 16 16 16 16 16 16 16 16 
17 17 77 16 16 16 16 16 16 16 76 17 17 17 17 17 17 17 81 80 16 78 79 79 79 82 17 17 17 17 17 17 81 79 79 79 79 79 79 79 80 16 16 16 16 16 16 16 16 16 
17 17 77 16 16 16 16 16 16 16 76 17 17 17 17 17 81 79 80 16 16 16 16 16 16 78 79 79 82 81 79 79 80 16 16 16 16 16 16 16 16 16 16 16 16 16 16 16 1 16 
17 17 83 75 16 16 16 16 16 16 78 82 17 17 81 79 80 16 16 16 16 16 16 16 16 16 16 16 78 80 16 16 16 16 16 16 16 16 16 16 16 16 16 16 16 16 1 16 16 1 
79 79 79 80 16 16 16 16 16 16 16 78 79 79 80 16 16 16 1 16 1 1 1 1 1 1 1 1 1 1 1 1 16 1 16 16 16 16 16 1 16 16 16 16 1 1 16 1 16 16 
16 16 16 16 16 16 16 16 16 16 1 1 1 16 16 16 16 16 16 1 1 1 1 1 1 1 1 1 1 1 1 1 1 1 1 1 1 16 16 16 1 16 16 1 16 16 16 16 16 16 
16 1 1 16 16 16 16 16 16 1 1 1 1 1 1 16 16 16 16 1 1 1 1 1 1 1 1 1 1 1 1 1 1 1 1 2 1 16 16 16 16 16 16 16 16 16 16 16 16 16 
16 1 16 16 16 16 1 16 16 1 1 1 1 1 1 16 1 16 16 1 1 1 1 1 1 1 1 1 1 2 1 1 1 2 1 1 1 16 16 1 1 16 16 1 16 16 16 1 16 1 
1 16 1 2 16 1 1 16 16 1 1 1 1 1 1 16 16 16 1 1 1 2 1 1 1 1 1 2 1 1 1 1 1 1 1 1 1 1 1 16 16 16 16 16 16 16 16 16 16 1 
16 16 1 16 1 16 16 16 16 1 1 1 1 1 1 16 16 16 16 1 2 1 1 1 1 1 1 1 1 1 1 1 1 1 1 1 16 1 1 1 1 16 16 1 16 16 1 16 16 1 
16 16 16 16 16 16 1 16 16 1 1 1 1 1 1 16 16 16 16 16 1 1 1 1 1 1 1 1 1 1 1 1 1 1 16 16 16 1 1 1 1 1 16 16 16 16 1 1 16 16 
1 16 1 16 16 16 16 16 16 1 1 1 1 1 1 16 1 16 16 16 16 1 1 1 1 1 1 1 1 2 1 16 1 16 16 16 1 1 1 1 1 1 16 16 16 16 16 16 16 1 
1 16 1 16 16 16 16 16 16 1 1 1 1 1 1 16 16 16 16 16 16 16 1 1 1 1 1 1 1 1 16 16 16 16 16 16 1 1 1 1 1 1 16 16 16 16 16 16 16 16 
1 16 16 1 16 1 16 16 16 16 1 1 1 1 1 16 16 1 16 16 16 16 16 16 16 1 1 16 16 16 16 16 16 1 1 1 2 1 1 1 1 1 16 16 16 1 1 16 1 16 
1 16 16 1 16 16 16 16 16 16 1 1 1 1 16 16 16 16 16 16 16 16 16 16 16 16 16 16 16 1 1 1 1 1 1 1 1 1 1 1 1 1 16 1 16 16 16 16 1 16 
16 16 16 16 16 16 1 16 16 16 16 16 16 16 16 16 16 16 16 16 16 16 16 16 16 16 16 1 1 1 1 1 1 1 1 1 1 1 2 1 1 1 16 16 16 16 16 1 16 1 
1 16 16 16 16 16 2 16 16 16 16 16 16 16 16 16 16 16 16 16 16 16 1 1 1 1 1 1 1 1 1 1 1 16 16 1 1 1 2 1 1 1 16 16 1 16 1 1 1 1 
16 16 16 1 1 16 1 16 16 16 16 16 16 16 16 16 16 16 16 16 16 16 16 16 16 1 1 1 1 1 1 1 1 16 16 1 1 1 1 2 1 16 16 1 16 16 16 1 1 1 
16 1 1 1 16 16 16 16 16 16 16 16 16 16 1 1 1 1 1 16 16 16 16 16 2 2 1 1 1 1 1 1 1 1 1 1 2 1 1 1 1 16 16 1 16 16 16 16 1 1 
1 16 16 16 16 1 16 16 16 16 16 16 1 2 1 1 2 1 1 16 16 16 1 1 1 1 16 16 1 1 1 1 1 1 1 1 1 16 16 1 1 1 16 16 16 16 16 1 16 1 
1 16 16 1 1 1 16 16 16 16 1 1 1 1 1 1 1 1 1 16 16 16 1 1 1 2 16 16 1 1 2 1 1 1 1 1 1 16 16 16 1 1 16 16 16 1 16 16 16 16 
1 16 16 16 16 16 16 16 16 1 1 1 1 1 1 1 1 1 1 1 16 16 1 1 1 1 1 1 1 1 1 1 1 1 1 1 1 1 1 1 1 1 16 1 2 16 16 16 16 16 
1 16 16 16 16 16 1 16 16 1 1 1 1 1 16 16 16 1 1 1 16 1 1 1 1 1 1 1 1 1 1 1 1 1 1 1 1 1 1 1 1 1 16 16 2 16 16 1 1 1 
1 16 2 16 1 1 16 16 16 1 1 16 16 1 2 1 16 1 1 1 1 1 1 16 16 16 16 16 16 1 1 1 16 1 16 16 16 16 1 2 16 16 16 1 1 16 16 1 16 16 
16 16 1 16 1 16 1 16 16 1 1 16 2 1 1 1 1 1 1 1 1 1 16 16 16 16 16 16 16 16 16 16 16 16 16 1 1 16 16 16 16 16 16 16 1 16 16 16 16 1 
16 1 1 1 16 2 1 16 16 1 1 1 1 1 1 1 1 1 1 12 10 10 10 13 1 1 1 1 16 16 1 16 16 1 1 1 1 1 16 16 16 16 16 1 1 16 1 16 16 1 
1 16 1 16 16 16 16 16 16 1 1 1 1 1 1 1 16 1 12 11 3 3 3 9 13 1 1 1 1 1 1 1 1 1 1 1 2 1 1 16 1 1 16 16 16 16 1 1 16 1 
1 16 16 16 16 1 16 16 16 1 1 1 1 2 16 16 16 1 8 3 3 3 3 3 7 1 1 1 1 1 1 1 1 1 2 1 1 1 1 1 1 1 16 16 16 16 16 16 16 16 
16 16 16 1 1 1 16 16 16 1 1 1 1 2 1 2 1 2 8 3 3 3 3 3 7 1 1 1 1 1 1 16 1 1 1 1 1 1 1 1 1 1 16 1 1 16 16 16 16 16 
1 1 1 16 16 16 16 16 16 1 1 1 1 1 1 1 1 1 14 6 3 3 3 4 15 1 16 16 16 16 16 16 16 1 20 21 21 21 21 21 21 21 21 21 21 21 21 21 21 21 
1 1 16 16 16 16 16 16 16 16 16 1 1 1 1 2 1 1 1 14 6 3 4 15 1 1 16 16 16 16 16 16 16 1 23 18 18 18 18 19 18 18 18 18 18 18 18 18 18 18 
1 16 16 16 16 16 16 16 16 16 1 16 16 1 1 1 1 1 2 1 8 3 7 1 1 16 16 16 16 20 21 21 21 21 31 18 18 18 18 18 18 18 18 18 18 18 19 18 18 18 
16 16 16 16 16 1 16 16 16 16 16 16 16 16 16 16 16 16 16 16 91 93 87 16 16 16 16 16 16 23 18 18 18 18 18 18 18 18 18 18 18 18 18 18 18 18 18 18 18 18 
16 1 1 16 16 16 16 16 16 16 16 16 16 16 16 16 16 16 16 16 16 95 16 16 16 16 1 16 16 23 18 18 18 18 19 18 18 18 19 18 19 18 18 19 18 18 18 18 18 18 
16 16 1 1 1 16 16 16 16 16 16 16 16 16 16 16 16 16 16 16 16 16 16 16 16 16 16 16 16 23 18 18 19 18 18 18 18 18 18 18 18 18 18 18 18 18 18 18 18 18 
16 16 16 16 16 16 1 16 16 16 16 16 16 16 16 16 16 16 16 16 16 16 16 16 16 16 16 16 16 23 18 18 18 18 18 18 18 18 18 18 18 18 18 18 18 18 18 19 18 18 
1 16 16 16 16 16 16 16 16 16 1 1 16 16 16 16 16 16 16 16 16 16 16 16 16 16 16 16 1 23 18 18 18 18 18 18 18 18 18 18 18 18 18 18 18 18 18 18 18 18 
1 1 16 16 16 16 1 16 16 16 16 16 16 1 16 16 16 16 16 16 16 16 16 16 16 16 16 16 1 23 18 18 18 19 19 19 18 18 18 18 18 19 19 18 18 18 19 18 18 18 
16 16 16 1 16 16 16 16 16 16 16 16 16 16 16 16 16 16 16 16 16 16 16 16 16 16 16 16 1 23 18 18 18 18 18 18 18 18 18 18 18 18 18 18 18 18 18 18 18 18 
16 16 16 16 16 16 16 16 16 1 16 16 16 1 1 16 16 16 16 16 16 16 16 16 16 16 16 1 1 23 18 18 18 18 18 18 18 18 18 18 18 18 18 18 18 18 18 18 18 18 
