1 1 1 1 1 1 1 1 1 1 1 1 1 1 1 1 1 1 1 1 1 1 1 1 1 1 1 1 1 1 1 1 1 1 1 1 1 1 1 1 1 1 1 1 1 1 1 1 1 1 
16 16 16 1 1 1 1 16 16 1 1 1 1 1 1 1 1 1 1 1 16 1 16 1 1 1 1 1 1 1 1 1 1 1 1 1 1 16 16 1 1 1 16 1 1 1 1 1 1 1 
16 1 16 16 16 16 16 16 16 16 16 16 16 16 1 1 16 16 16 16 16 16 16 16 16 16 16 16 1 16 16 1 16 16 1 1 16 16 16 1 16 16 16 1 16 1 1 16 16 1 
16 1 16 1 16 16 1 16 1 1 16 1 16 16 16 16 16 16 16 16 16 16 16 16 16 16 16 16 16 1 1 1 16 16 1 16 16 16 1 1 16 16 16 1 16 16 16 16 1 1 
1 1 16 16 16 16 16 16 16 16 16 1 16 16 1 1 16 16 16 16 16 16 16 1 16 16 16 16 1 16 16 1 1 1 1 16 1 16 16 16 16 16 16 16 16 16 16 1 16 16 
16 16 16 1 16 16 16 16 16 16 16 16 16 16 16 16 16 16 16 16 16 16 1 16 16 16 1 16 16 16 16 16 1 16 16 16 16 16 16 16 16 16 16 16 1 16 16 1 16 16 
16 16 16 16 1 16 16 16 16 16 16 16 16 16 1 16 16 1 16 16 16 16 16 16 16 16 16 16 1 1 16 1 1 16 16 16 1 1 16 1 1 16 16 16 16 16 16 1 1 1 
1 1 16 1 16 16 16 16 16 16 1 1 1 1 1 16 16 16 16 1 16 16 16 1 16 16 16 1 16 16 16 16 16 16 16 16 16 16 16 16 16 16 16 1 16 16 16 16 1 1 
21 21 21 21 21 22 16 16 16 16 1 1 1 1 16 1 16 16 16 16 16 16 16 1 1 16 16 1 16 16 16 16 16 16 16 16 16 16 16 16 16 16 1 16 1 16 16 1 1 16 
18 18 18 18 19 24 16 16 16 16 16 1 1 1 16 1 16 16 1 1 1 1 1 1 1 1 1 1 1 1 1 16 16 16 16 16 16 16 1 16 16 16 16 1 16 1 1 16 16 1 
18 18 18 18 18 24 16 16 1 16 1 1 1 1 1 1 16 16 1 1 1 1 1 16 16 16 1 16 1 1 1 1 1 1 16 1 16 16 1 1 16 16 16 16 16 16 16 1 1 16 
18 18 19 18 18 24 16 16 16 16 16 1 1 1 1 1 1 1 1 1 1 1 16 16 1 1 1 1 16 1 2 1 1 1 16 12 10 10 10 86 16 16 16 16 16 16 16 16 16 16 
18 19 18 18 19 30 22 16 16 16 16 1 1 1 1 2 1 2 1 1 1 1 1 1 20 21 21 21 22 16 1 1 1 1 2 8 3 3 3 85 97 16 16 16 16 16 16 16 16 16 
26 26 26 26 26 26 27 16 1 16 1 1 1 1 1 1 1 1 1 1 1 2 16 16 23 18 19 18 30 21 21 22 1 1 1 8 3 4 5 87 16 16 16 16 16 16 16 16 16 16 
1 1 16 16 16 16 16 16 16 16 16 1 1 1 1 1 2 1 1 1 1 1 16 1 23 19 18 28 26 26 26 27 1 16 1 8 3 7 1 1 16 1 16 16 16 16 1 16 16 16 
16 1 1 16 16 16 16 16 16 16 16 16 1 1 1 1 1 1 1 2 1 1 1 16 25 26 26 27 16 1 16 16 16 16 1 14 5 15 1 2 16 16 16 1 16 16 16 16 1 1 
1 16 1 16 16 1 16 16 1 16 16 16 1 1 16 1 1 1 1 1 1 1 1 1 16 16 1 1 1 16 16 16 1 2 1 1 1 1 1 1 16 16 16 16 1 16 16 16 16 1 
1 16 16 1 1 16 16 16 1 16 16 1 1 16 16 16 16 1 16 16 16 1 1 1 1 1 16 16 1 16 16 16 1 1 1 1 1 16 1 1 16 1 16 16 16 16 16 16 1 16 
1 16 16 16 16 16 16 16 1 16 16 16 16 1 1 16 1 1 1 1 16 1 1 1 1 1 16 16 16 16 1 1 1 1 1 16 1 16 16 1 16 16 16 16 1 16 1 16 1 16 
1 16 16 16 16 16 16 16 1 1 16 1 16 16 16 16 1 16 1 1 16 1 1 1 1 1 1 16 16 1 1 1 16 16 16 16 1 16 16 16 16 16 16 16 16 16 1 16 1 1 
1 16 1 16 16 1 16 16 16 16 16 16 16 16 16 1 16 16 1 1 1 1 1 16 16 1 1 1 16 16 16 16 16 16 16 1 2 1 16 16 16 16 16 16 1 1 16 16 16 16 
1 16 1 16 16 16 16 16 16 16 1 1 16 1 1 1 1 16 1 16 16 1 16 1 16 1 1 1 1 16 16 16 16 1 1 1 1 1 1 16 16 1 16 16 1 16 1 16 16 16 
1 16 1 16 1 1 16 16 16 16 16 1 12 10 10 10 13 1 1 1 16 1 16 16 16 16 16 1 1 16 16 1 1 2 1 1 1 1 1 1 16 1 16 16 16 16 16 16 16 1 
16 16 16 16 1 16 16 16 1 16 1 12 11 3 3 3 9 10 10 10 13 1 16 16 16 16 16 2 1 1 1 1 1 12 10 86 16 16 1 16 16 1 16 1 16 16 16 16 16 16 
1 1 16 16 1 1 16 16 16 16 1 8 3 3 3 3 3 3 3 3 9 13 16 16 16 16 16 16 1 1 1 16 16 8 3 7 16 12 10 13 16 16 16 16 16 1 1 1 16 16 
16 16 1 16 16 1 1 16 1 16 1 8 3 3 3 3 3 3 3 3 3 7 1 16 16 16 16 16 16 1 1 12 10 11 3 9 10 11 3 7 16 16 16 20 21 21 21 21 21 21 
16 1 1 16 1 1 1 16 16 16 1 14 6 3 3 3 3 3 3 3 4 15 1 16 16 16 16 1 16 1 12 11 3 3 3 3 3 3 3 7 16 16 16 25 29 18 18 18 18 18 
1 16 1 16 1 16 1 16 16 16 16 1 14 6 3 3 3 3 3 3 7 1 1 16 16 16 16 16 16 1 8 3 3 3 3 3 3 3 3 7 16 1 16 16 23 18 18 18 18 18 
1 16 16 1 16 16 16 16 16 16 16 1 1 14 5 6 3 4 5 5 15 2 1 16 1 16 16 16 16 1 91 5 5 6 3 3 3 3 3 7 16 16 16 16 23 18 18 18 18 18 
16 16 16 1 16 16 1 16 16 16 1 1 16 1 1 14 5 15 1 1 1 1 16 16 16 1 16 1 16 1 1 16 16 8 3 4 5 6 3 7 16 16 16 16 23 18 18 18 18 18 
16 1 1 1 16 16 1 16 1 16 1 1 16 1 16 1 1 2 1 16 16 1 1 1 16 16 16 16 16 1 1 1 16 8 3 7 16 91 5 15 16 16 16 20 31 18 18 18 18 18 
1 1 1 16 16 1 1 16 16 16 1 1 16 1 1 16 1 16 1 1 16 16 16 16 16 16 16 16 16 16 1 1 1 14 5 15 1 1 16 16 16 16 16 23 18 18 18 18 18 18 
16 16 1 16 1 16 1 16 16 16 1 1 16 1 16 16 16 16 16 16 16 16 16 16 16 16 16 16 16 16 16 16 16 1 2 1 2 1 16 1 16 1 20 31 18 18 18 18 18 18 
16 16 16 16 16 16 16 16 16 16 16 16 16 1 16 16 16 16 16 16 16 16 16 16 16 16 16 16 16 16 1 16 16 1 16 1 1 16 1 1 16 16 25 26 29 18 28 26 26 26 
1 16 16 16 16 16 16 16 16 16 16 16 16 1 16 16 16 16 16 16 16 16 16 16 16 16 16 16 16 16 2 1 1 1 16 16 16 16 16 16 16 16 73 75 25 26 27 16 16 1 
1 16 16 1 1 16 16 1 1 16 16 1 16 1 1 16 16 16 1 1 1 16 16 16 16 16 16 16 16 16 1 16 16 1 1 16 16 16 16 16 73 74 84 83 74 74 74 74 74 74 
1 16 16 16 16 1 16 16 16 16 16 16 16 1 1 1 1 1 1 16 1 16 16 16 16 16 16 16 16 16 16 16 12 10 10 10 10 86 16 73 84 17 17 17 17 17 17 17 17 17 
1 16 16 16 1 16 16 16 16 16 16 16 16 16 1 1 1 1 1 16 1 1 16 2 1 1 2 1 1 16 16 12 11 3 3 3 3 85 88 89 17 90 90 17 17 90 90 90 90 90 
1 16 16 16 1 16 16 16 16 16 16 16 1 16 16 16 16 16 16 16 1 1 1 1 12 10 10 10 10 10 10 11 3 3 4 5 5 87 16 78 79 82 17 17 17 17 17 17 17 17 
1 16 1 16 1 1 1 16 1 16 16 1 16 16 16 16 16 16 16 16 16 16 1 1 8 3 3 3 3 3 3 3 3 4 15 1 20 22 16 16 16 78 79 82 17 17 17 17 17 17 
1 16 16 16 16 16 1 16 16 16 16 1 1 16 16 1 1 16 16 16 16 16 16 1 8 3 4 5 5 5 5 5 5 15 1 1 25 27 1 16 16 16 16 76 17 17 17 17 17 17 
16 16 16 16 16 16 16 16 16 16 1 16 1 16 16 16 16 16 16 16 16 16 16 1 8 3 7 16 16 1 2 16 16 16 1 1 2 1 16 16 16 16 16 76 17 17 17 17 17 17 
16 16 16 16 16 1 16 16 16 16 16 1 16 16 1 16 16 16 16 16 16 16 16 16 91 93 87 16 16 16 1 16 16 16 2 1 1 1 1 1 16 16 73 17 17 17 17 17 17 17 
16 16 16 1 16 16 16 16 16 16 16 16 16 1 1 16 16 1 16 1 1 16 16 16 16 95 16 16 16 16 16 16 16 16 16 16 16 16 16 16 73 74 84 17 17 17 17 17 17 17 
16 16 16 16 16 16 16 16 16 16 1 16 16 16 16 16 16 16 1 16 16 16 16 16 16 16 16 16 16 16 1 16 1 16 16 1 16 16 16 16 78 79 79 79 79 79 79 79 82 17 
16 1 16 16 1 16 16 16 16 16 16 16 16 16 1 1 16 16 1 16 16 1 16 16 16 16 16 16 16 16 16 1 16 1 1 1 16 1 1 1 2 16 16 16 16 1 1 16 78 79 
1 16 16 16 16 16 1 16 1 16 16 1 1 16 1 1 1 1 16 1 16 16 16 16 16 16 16 1 16 16 1 16 1 1 1 16 16 16 16 16 2 16 16 1 16 1 1 2 16 16 
16 16 16 16 16 16 16 16 16 16 16 16 16 16 16 16 1 16 16 1 1 16 1 16 16 16 16 1 16 16 16 16 16 16 16 16 16 16 16 2 16 16 16 16 16 16 16 2 16 16 
16 16 16 16 16 16 16 16 16 16 16 16 16 16 16 16 16 16 16 16 16 16 1 16 16 16 16 16 16 16 1 16 16 16 16 16 1 16 1 16 16 16 16 16 16 16 16 2 16 16 
16 16 16 16 16 16 16 16 16 16 16 16 16 1 1 1 1 1 16 16 16 16 16 16 16 16 16 16 16 16 16 16 16 1 16 16 16 16 16 16 16 16 16 16 16 16 16 16 16 16 
