16 16 16 16 16 16 16 16 16 16 16 16 16 16 16 16 16 16 16 16 16 16 16 16 16 16 16 16 16 16 16 16 16 16 16 16 8 3 7 16 16 16 16 16 16 16 16 16 16 16 
16 1 1 16 16 16 16 1 16 1 16 16 1 1 16 16 16 16 16 16 1 1 16 16 16 16 16 16 16 16 16 16 16 16 16 16 8 3 7 16 16 16 16 1 16 16 16 16 16 16 
16 16 16 16 16 16 16 16 16 16 16 16 16 16 16 16 16 16 16 16 16 16 16 16 16 1 16 1 16 16 16 1 16 1 1 16 8 3 7 16 16 16 16 16 16 16 16 16 16 16 
16 16 16 16 16 16 16 16 16 16 16 16 1 16 16 16 16 16 16 16 16 16 16 16 16 16 16 16 16 16 16 16 16 16 1 1 8 3 7 16 16 16 16 16 1 1 16 16 16 16 
16 16 16 1 16 16 1 1 16 1 1 1 16 16 16 16 16 16 16 16 1 1 16 16 16 16 16 16 1 16 16 16 16 16 1 16 8 3 7 1 16 16 1 16 16 1 16 16 16 16 
16 16 1 1 16 16 16 16 16 16 1 1 16 16 16 16 16 16 16 16 16 1 16 16 16 16 16 16 16 16 16 16 16 16 16 16 8 3 7 16 16 1 16 16 16 16 16 16 16 16 
16 16 16 16 16 16 16 16 1 16 16 16 16 16 16 16 1 16 1 16 16 16 16 16 16 16 16 16 16 16 16 16 16 16 16 16 8 3 7 16 16 16 16 16 1 16 16 16 16 16 
16 16 16 16 1 16 16 1 16 16 16 16 16 16 16 16 16 16 16 16 1 16 16 16 16 16 16 16 16 16 16 16 16 16 16 16 8 3 7 16 16 1 16 16 16 16 16 16 16 16 
16 16 16 16 16 16 16 16 16 16 16 16 16 16 16 16 16 16 16 16 1 16 16 16 16 16 16 16 1 16 1 16 16 16 16 16 8 3 7 16 16 16 16 16 16 16 1 1 16 16 
16 16 16 16 1 1 16 16 16 16 16 16 16 16 16 16 16 1 16 16 16 16 16 16 16 16 16 16 16 16 16 1 16 16 1 16 8 3 16 16 16 16 16 1 16 16 16 1 16 1 
16 16 16 16 1 1 16 16 16 16 16 16 1 16 16 16 1 1 1 16 1 16 16 16 1 1 16 16 16 16 16 1 1 16 1 16 8 3 7 16 16 16 1 16 16 16 16 1 16 16 
16 16 16 16 16 16 16 16 16 16 16 1 1 16 16 16 16 1 1 16 16 16 16 16 16 16 16 16 16 16 16 16 16 1 1 1 8 3 7 1 16 16 16 16 16 16 16 16 16 1 
16 16 16 16 16 16 16 16 16 16 16 16 16 16 16 16 16 1 16 1 16 16 16 16 16 16 16 16 16 16 1 1 16 16 16 1 8 3 7 16 16 16 16 16 16 16 1 16 16 1 
16 16 16 1 1 16 16 1 1 16 16 16 16 16 16 16 16 16 16 16 16 16 16 16 16 16 1 1 1 1 16 16 1 16 1 16 8 3 7 1 16 1 1 16 16 16 16 16 16 1 
16 16 16 16 1 1 1 16 1 16 16 16 1 1 16 16 16 16 1 1 16 16 16 1 16 16 16 16 1 16 16 16 16 16 16 1 8 3 7 1 16 1 1 16 1 16 1 16 16 1 
1 16 1 16 16 16 16 16 16 16 1 16 16 16 16 1 1 1 1 1 1 16 16 16 16 16 16 16 16 16 1 16 16 16 16 16 8 3 7 1 16 16 1 16 16 16 16 16 1 1 
21 21 21 21 21 21 21 21 21 21 21 21 21 21 21 21 22 16 16 16 1 16 16 16 16 16 16 16 16 16 16 16 16 16 16 16 8 3 7 1 16 16 16 16 16 16 16 16 1 1 
18 18 18 18 18 18 18 18 18 18 18 18 18 18 18 18 30 22 1 1 1 16 16 16 16 16 16 16 16 1 16 16 16 16 16 16 14 93 15 1 16 1 16 16 16 16 16 1 16 16 
18 18 18 18 18 18 18 18 18 18 18 18 18 18 18 18 18 24 1 1 16 16 16 16 16 16 1 16 16 16 16 16 1 16 16 16 16 95 16 16 16 16 1 16 16 16 16 16 16 16 
18 18 18 18 18 18 18 18 18 18 18 18 18 18 18 18 18 24 1 1 16 1 16 16 16 1 16 1 16 16 16 16 16 16 16 16 16 16 16 16 16 1 1 16 1 16 1 16 16 1 
18 18 18 18 18 18 18 18 18 18 18 18 18 18 18 18 18 24 1 16 16 16 16 16 1 16 16 1 1 16 16 1 16 16 16 16 16 16 16 16 16 16 1 16 16 16 16 16 16 16 
18 18 18 18 18 18 18 18 18 18 18 18 18 18 18 18 18 24 1 16 16 16 16 16 1 1 1 16 16 16 16 1 1 16 16 16 16 96 16 16 16 16 1 16 16 16 16 16 16 16 
18 18 18 18 18 18 18 18 18 18 18 18 18 18 18 18 18 24 1 16 16 16 16 16 16 1 16 16 16 1 16 16 1 16 16 16 99 94 86 16 16 16 1 1 1 16 1 16 1 16 
18 18 18 18 18 18 18 18 18 18 18 18 18 18 18 18 18 24 1 16 16 16 1 16 16 16 1 16 16 1 16 16 16 16 16 16 8 3 7 16 16 16 16 1 16 16 16 16 1 16 
18 18 18 18 18 18 18 18 18 18 18 18 18 18 18 18 18 24 16 16 16 1 16 16 1 16 16 1 16 16 16 16 16 16 16 2 8 3 7 16 16 16 1 16 16 16 16 16 16 1 
18 18 18 18 18 18 18 18 18 18 18 18 28 26 26 26 26 27 16 16 16 16 16 16 16 16 16 16 16 16 1 16 16 1 16 16 8 3 7 1 16 16 1 1 16 16 16 16 16 16 
18 18 18 18 18 18 18 18 18 28 26 26 27 1 1 1 1 1 1 16 1 16 16 16 16 1 1 16 16 16 16 16 16 1 1 1 8 3 7 1 16 1 16 16 16 16 16 16 16 16 
18 18 18 18 18 18 18 18 28 27 1 1 1 1 1 1 1 1 1 16 16 1 1 1 16 16 16 16 16 16 16 1 16 16 16 16 8 3 7 1 16 1 16 1 16 16 16 1 16 16 
18 18 18 18 18 18 18 18 24 1 1 1 16 16 16 16 1 1 1 16 1 16 16 16 16 16 16 16 1 16 16 16 16 16 1 1 8 3 7 1 16 16 16 16 16 16 1 16 16 1 
18 18 18 18 18 18 18 18 24 1 1 16 16 16 16 16 16 16 16 16 16 16 16 16 16 1 1 1 1 16 16 16 16 16 16 1 8 3 7 16 16 1 16 16 16 16 16 1 16 16 
18 18 18 18 18 18 18 18 24 1 1 16 1 1 16 1 16 16 16 1 16 16 1 16 16 16 16 16 16 16 16 1 16 1 16 1 8 3 7 16 16 16 16 16 16 16 1 16 16 16 
18 18 18 18 18 18 18 18 24 16 1 16 16 16 16 16 16 16 16 1 16 16 16 16 16 16 16 16 16 16 1 16 1 1 1 1 8 3 7 1 16 1 16 16 16 16 16 16 16 1 
18 18 18 18 18 18 18 18 24 16 1 1 16 1 16 16 16 16 1 16 16 16 16 16 16 16 2 16 1 1 1 1 1 1 1 12 11 3 7 16 16 16 16 16 16 16 16 16 1 16 
18 18 18 18 18 18 18 18 24 16 1 16 16 16 16 16 16 16 16 16 16 1 16 16 1 12 10 10 10 10 10 10 10 10 10 11 3 3 7 1 16 16 16 16 16 16 16 1 16 16 
18 18 18 18 18 18 18 18 24 16 1 16 16 1 1 1 1 1 1 1 1 1 1 1 12 11 3 3 3 3 3 3 3 3 3 3 3 4 87 16 16 16 16 16 16 16 16 16 16 1 
18 18 18 18 18 18 18 18 24 16 1 1 1 2 1 1 1 1 1 1 1 1 1 1 8 3 3 4 5 5 5 5 5 5 5 5 5 87 16 16 16 16 16 16 16 16 16 16 16 16 
18 18 18 18 18 18 18 18 24 1 1 1 1 2 1 1 1 1 1 1 2 2 1 1 8 3 4 15 1 1 16 1 1 1 2 1 1 1 16 16 16 16 1 16 16 1 1 16 1 16 
18 18 18 18 18 18 18 18 24 1 2 1 1 1 1 1 1 1 12 10 13 1 1 1 8 3 7 1 2 16 16 1 1 1 1 1 1 1 1 16 16 16 16 16 16 16 16 16 16 16 
18 18 18 18 18 18 18 18 24 1 1 1 1 1 1 1 1 1 8 3 9 10 10 10 11 3 7 16 16 1 20 21 21 21 21 21 21 21 21 21 22 16 16 1 1 1 16 16 16 16 
18 18 18 18 18 18 18 18 24 1 1 1 1 20 21 22 1 1 8 3 3 3 3 3 3 3 7 16 1 1 23 18 18 18 18 18 18 18 18 18 30 21 22 16 16 16 16 1 1 16 
18 18 18 18 18 18 18 18 30 22 1 1 1 25 26 27 1 1 14 5 5 5 5 5 5 5 15 1 1 20 31 18 18 18 18 18 18 18 18 18 18 18 24 16 16 16 16 16 16 16 
18 18 18 18 18 18 18 18 18 30 21 22 1 1 1 1 1 1 1 1 1 1 1 1 1 1 20 21 21 31 18 18 18 18 18 18 18 18 18 18 18 28 27 1 16 16 16 16 16 1 
18 18 18 18 18 18 18 18 18 18 18 30 22 1 1 2 1 1 1 1 20 21 21 21 21 21 31 18 18 18 18 18 18 18 18 18 18 18 18 18 18 24 1 1 16 16 16 16 16 16 
18 18 18 18 18 18 18 18 18 18 18 18 30 22 1 1 1 1 1 20 31 18 18 18 18 18 18 18 18 18 18 18 18 18 18 18 18 18 18 18 28 27 1 1 16 16 16 16 16 16 
18 18 18 18 18 18 18 18 18 18 18 18 18 30 21 21 21 21 21 31 18 18 18 18 18 18 18 18 18 18 18 18 18 18 18 18 18 28 26 26 27 1 1 16 16 16 16 16 16 16 
18 18 18 18 18 18 18 18 18 18 18 18 18 18 18 18 18 18 18 18 18 18 18 18 18 18 18 18 18 18 18 18 18 18 18 28 26 27 1 1 1 16 16 16 16 16 16 16 16 16 
18 18 18 18 18 18 18 18 18 18 18 18 18 18 18 18 18 18 18 18 18 18 18 18 18 18 18 18 18 18 18 18 28 26 26 27 1 1 1 1 16 16 16 16 16 1 16 1 16 16 
18 18 18 18 18 18 18 18 18 18 18 18 18 18 18 18 18 18 18 18 18 18 18 18 18 18 18 18 18 18 18 28 27 1 1 1 16 1 16 16 16 16 16 1 16 16 16 16 16 16 
18 18 18 18 18 18 18 18 18 18 18 18 18 18 18 18 18 18 18 18 18 18 18 18 18 18 18 18 18 28 26 27 1 1 16 16 16 16 16 16 1 16 16 16 16 1 16 16 16 16 
18 18 18 18 18 18 18 18 18 18 18 18 18 18 18 18 18 18 18 18 18 18 18 18 18 18 18 18 28 27 1 1 1 16 1 16 16 16 16 16 16 1 16 1 16 16 1 16 1 16 
